{
  "id": 1004,
  "biome_tiles": {
    "tiles": [
      "222222222222222222222222222222222222222222222222222222222222222222222222222222222222222222222222222222222222222222222222",
      "222222222222222222222222222222222222222222222222222222222222222222222222222222222222222222222222222222222222222222222222",
      "222222222222222222222222222222222222244444222222224444444444444422222222222222222222222222222222222222222222222222222222",
      "222222222222222222222244422222222224444444444444444444444444444444222222244444222222222222222222222222222222222222222222",
      "222222222222222222222444442222222444441111444444444111111111111144442424444444442222222222222222222222222222222222222222",
      "222222222222222222222244444224222444111111111111111111111111111111444444441111442242424222222222222222222222222222222222",
      "222222222222222222222444144444244441111111111111111111111111111111114444111111444444444222222222222222222222222222222222",
      "222222222222222222222244111444444411111111111111111111111111111111111111111111114444444422222222222222222222222222222222",
      "222222222222222222222244111111441111111111111111111111111111111111111111111111111111114442244224442222222222222222222222",
      "222222222222242422224244111111111111111111111111111111111111111111111111111111111111144222444444442222222222222222222222",
      "222222222222444422444444111111111111111111111111111111111111111111111111111111111111144422244444444222222222222222222222",
      "222222222224442224444441111111111111111111111111111111111111111111111111111111111111114424444111144222222222222222222222",
      "222222222244444222441111111111111111111111111111111111111111111111111111111111111111114444441111144442222222222222222222",
      "222222222244444244441111111111111111111111111111111111111111111111111111111111111111111144111111111444222222222222222222",
      "222222222224444444411111111111111111111111111111111111111111111111111111111111111111111111111111111144442222222222222222",
      "222222222222441441111111111111111111111111111111111111111111111111111111111111111111111111111111111111444222222222222222",
      "222222222222441111111111111111111111111111111111111111111111111111111111111111111111111111111111111111144444222222222222",
      "222222222222441111111111111111111111111111111111111111111111111111111111111111111111111111111111111111114422222222222222",
      "222222444444441111111111111111111111111111111111111111111111111111111111111111111111111111111111111111114422222222222222",
      "222224444444411111111111111111111111111111111111111111111111111111111111111111111111111111111111111111144222222222222222",
      "222222441111111111111111111111111111111111111111111111111111111111111111111111111111111111111111111111144422222222444222",
      "222222441111111111111111111111111111111111111111111111111111111111111111111111111111111111111111111111114444444444444222",
      "222222441111111111111111111111111111111111111111111111111111111111111111111111111111111111111111111111111144444444442222",
      "222224441111111111111111111111111111111111111111111111111111111111111111111121111111111111111111111111111111111111442222",
      "222244411111111111111111111111111111111111111111111111111111111111111111112221111111111111111111111111111111111111442222",
      "222444111111111111111111111111111111111111111111111111111111111111111111122111111111111111111111111111111111111111442222",
      "222441111111111111111111111111111111111111111111111111111111111111111111221111111111111111111111111111111111111111442222",
      "224441111111111111111111111111111111111111111111111111111111111111111111211111111111111111111111111111111111111111444222",
      "224411111111111111111111111111111111111111111111111111111111111111111111211111111111111111111111111111111111111111144222",
      "224411111111111111111111111111111111111111111111111111111111111111111112111111111111111111111111111111111111111111144422",
      "224411111111111111111111111111111111111111111111111111111111111111111112211111111111111111111111111111111111111111144222",
      "224411111111111111111111111111111111111111111111111111111111111111111111211111111111111111111111111111111111111111144222",
      "222221111111111111111111111111111111111111111111111111111111111111111111211111111111111111111111111111111111111111442222",
      "224442222111111111111111111111111111111111111111111111111111111111111111211111111111111111111111111111111111111111444222",
      "224444422221111111111111111111111111111111111111111111111111111111111111211111111111111111111111111111111111111111442222",
      "224442221112211111111111111111111111111111111111111111111111111111111111211111111111111111111111111111111111111111444222",
      "224422111122221111111111111111111111111111111111111111111111111111111111211111111111111111111111111111111111111111144222",
      "222224411222222222211111112222222222222222222222222222222214111111111111211111111111111111111111111111111111111111144222",
      "222444112242222222222222222222222222222211111111111112222224441111111412111111111111111111111111111111111111111111144222",
      "222444222441111112222222222111111111111111111111111111111222244441144422111111111111111111111111111111111111111111144222",
      "222422244411111111111111111111111111111111111111111111111111222244442221111111111111111111111111111111111111111111144222",
      "222221144111111111111111111111111111111111111111111111111111112222222211111111111111111111111111111111111111111111144222",
      "222444111111111111111111111111111111111111111111111111111111111112222222222222222211111111111111111111111111111111144422",
      "224441111111111111111111111111111111111111111111111111111111111111111111111111111221111111111111111111111111111111114422",
      "224411111111111111111111111111111111111111111111111111111111111111111111111111111122111111111111111111111111111111114422",
      "222441111111111111111111111111111111111111111111111111111111111111111111111111111112211111111111111111111111111111114422",
      "222441111111111111111111111111111111111111111111111111111111111111111111111111111111211111111111111111111111111111144222",
      "222441111111111111111111111111111111111111111111111111111111111111111111111111111111221111111111111111111111111111144422",
      "222441111111111111111111111111111111111111111111111111111111111111111111111111111111121111111111111111111111111111144222",
      "222441111111111111111111111111111111111111111111111111111111111111111111111111111111121111111111111111111111111111144422",
      "224441111111111111111111111111111111111111111111111111111111111111111111111111111111122111111111111111111111111111144222",
      "222444411111111111111111111111111111111111111111111111111111111111111111111111111111112211111111111111111111111111144222",
      "222244411111111111111111111111111111111111111111111111111111111111111111111111111111111211111111111111111111111441144222",
      "222222441111111111111111111111111111111111111111111111111111111111111111111111111111111211111111111111111111114444444222",
      "222224441111111111111111111111111111111111111111111111111111111111111111111111111111111222111111111111111111444244442222",
      "222224411111111111111111111111111111111111111111111111111111111111111111111111111111111111111111111111111114442222422222",
      "222244411111111111111111111111111111111111111111111111111111111111111111111111111111111111111111111111111144222222422222",
      "222444111111111111111111111111111111111111111111111111111111111111111111111111111111111111111111111111111442222222222222",
      "22244411111111111111111A111111111111111111111111111111111111111111111111111111111111111111111111111111114422222222222222",
      "222244441111111111111111A1A1A1111111111111111111111111111111111111111111111111111111111111111111111111114442222222222222",
      "22222444111111111111111A111A11A11111111111111111111111111111111111111111111111111111111111111111144441111442222222222222",
      "2222222441111111111A111A1AAAAAA11111111111111111111111111111111111111111111111111111111111111111444444111442222222222222",
      "222222244111111111111AA1AA888AA1A111111111111111111111111111111111111111111111111111111111111114424244441442222222222222",
      "222222224411111111111A11AA8888AAA111111111111111111111111111111111111111111111111111111111111114422224444422222222222222",
      "22222222441111111111AA1AA888888AAA11111111111111111111111111111111111111111111111111111111111114422222244222222222222222",
      "2222222224411111111AA1AA88888888A111111111111111111111111111111111111111111111111111111111111114444222222222222222222222",
      "2222222244411111111111AAAA888888A111111111111111111111111111111111111111111111111111111111111111144422222222222222222222",
      "22222222244111111111A11AAA888888A1A1111111111111111111111111111111111111111111111111111111111111114422222222222222222222",
      "2222222244444111111111A11AAAA88AA111111111111111111111111111111111111111111111111111111111111111114422222222222222222222",
      "22222222224444411111111A11AAAAAA1AA1111111111111111111111111111111111111111111111111111111111111444442222222222222222222",
      "22222222222244411111111AA111AA111A11111111111111111111111111111111111111111111111111111111111114444422222222222222222222",
      "222222222222224441111111111A11111111111111111111111111111111111111111111111111111111111111111444222222222222222222222222",
      "222222222222224444411111111AA1A11A11111111111111111111111111111111111111111111111111111111144442222222222222222222222222",
      "222222222222222244441111111111111111111111111111111111111111111111111111111111111114441111444222222222222222222222222222",
      "222222222222222222444111111111144111111111111111111111111111111111111111111111111444444444422222222222222222222222222222",
      "222222222222222222244444444444444444444444411111111111111111111111111111444444444442244444222222222222222222222222222222",
      "222222222222222222224444444444424444444444444444444444444444444444444144444444444222222422222222222222222222222222222222",
      "222222222222222222222422222422222242424242444444444444444444444444444444242222222222222222222222222222222222222222222222",
      "222222222222222222222222222222222222222222222222222222222222222222224422222222222222222222222222222222222222222222222222",
      "222222222222222222222222222222222222222222222222222222222222222222222222222222222222222222222222222222222222222222222222"
    ],
    "sheet_id": 1002
  },
  "constructions_tiles": {
    "tiles": [
      "000000000000000000000000000000000000000000000000000000000000000000000000000000000000000000000000000000000000000000000000",
      "000000000000000000000000000000000000000000000000000000000000000000000000000000000000000000000000000000000000000000000000",
      "000000000000000000000000000000000000000000000000000000000000000000000000000000000000000000000000000000000000000000000000",
      "000000000000000000000000000000000000000000000000000000000000000000000000000000000000000000000000000000000000000000000000",
      "000000000000000000000000000000000000000000000000000000000000000000000000000000000000000000000000000000000000000000000000",
      "000000000000000000000000000000000000000000000000000000000000000000000000000000000000000000000000000000000000000000000000",
      "000000000000000000000000000000000000000000000000000000000000000000000000000000000000000000000000000000000000000000000000",
      "000000000000000000000000000000000000000000000000000000000000000000000000000000000000000000000000000000000000000000000000",
      "000000000000000000000000000000000000000000000000000000000000000000000000000000000000000000000000000000000000000000000000",
      "000000000000000000000000000000000000000000000000000000000000000000000000000000000000000000000000000000000000000000000000",
      "000000000000000000000000000000000000000000000000000000000000000000000000000000000000000000000000000000000000000000000000",
      "000000000000000000000000000000000000000000000000000000000000000000000000000000000000000000000000000000000000000000000000",
      "000000000000000000000000000000000000000000000000000000000000000000000000000000000000000000000000000000000000000000000000",
      "000000000000000000000000000000000000000000000000000000000000000000000000000000000000000000000000000000000000000000000000",
      "000000000000000000000000000000000000000000000000000000000000000000000000000000000000000000000000000000000000000000000000",
      "000000000000000000000000000000000000000000000000000000000000000000000000000000000000000000000000000000000000000000000000",
      "000000000000000000000000000000000000000000000000000000000000000000000000000000000000000000000000000000000000000000000000",
      "000000000000000000000000000000000000000000000000000000000000000000000000000000000000000000000000000000000000000000000000",
      "000000000000000000000000000000000000000000000000000000000000000000000000000000000000000000000000000000000000000000000000",
      "000000000000000000000000000000000000000000000000000000000000000000000000000000000000000000000000000000000000000000000000",
      "000000000000000000000000000000000000000000000000000000000000000000000000000000000000000000000000000000000000000000000000",
      "000000000000000000000000000000000000000000000000000000000000000000000000000000000000000000000000000000000000000000000000",
      "000000000000000000000000000000000000000000000000000000000000000000000000000000000000000000000000000000000000000000000000",
      "000000000000000000000000000000000000000000000000000000000000000000000000000000000000000000000000000000000000000000000000",
      "000000000000000000000000000000000000000000000000000000000000000000000000000000000000000000000000000000000000000000000000",
      "000000000000000000000000000000000000000000000000000000000000000000000000000000000000000000000000000000000000000000000000",
      "000000000000000000000000000000000000000000000000000000000000000000000000000000000000000000000000000000000000000000000000",
      "000000000000000000000000000000000000000000000000000000000000000000000000000000000000000000000000000000000000000000000000",
      "000000000000000000000000000000000000000000000000000000000000000000000000000000000000000000000000000000000000000000000000",
      "000000000000000000000000000000000000000000000000000000000000000000000000000000000000000000000000000000000000000000000000",
      "000000000000000000000000000000000000000000000000000000000000000000000000000000000000000000000000000000000000000000000000",
      "000000000000000000000000000000000000000000000000000000000000000000000000000000000000000000000000000000000000000000000000",
      "000000000000000000000000000000000000000000000000000000000000000000000000000000000000000000000000000000000000000000000000",
      "000000000000000000000000000000000000000000000000000000000000000000000000000000000000000000000000000000000000000000000000",
      "000000000000000000000000000000000000000000000000000000000000000000000000000000000000000000000000000000000000000000000000",
      "000000000000000000000000000000000000000000000000000000000000000000000000000000000000000000000000000000000000000000000000",
      "000000000000000000000000000000000000000000000000000000000000000000000000000000000000000000000000000000000000000000000000",
      "000000000000000000000000000000000000000000000000000000000000000000000000000000000000000000000000000000000000000000000000",
      "000000000000000000000000000000000000000000000000000000000000000000000000000000000000000000000000000000000000000000000000",
      "000000000000000000000000000000000000000000000000000000000000000000000000000000000000000000000000000000000000000000000000",
      "000000000000000000000000000000000000000000000000000000000000000000000000000000000000000000000000000000000000000000000000",
      "000000000000000000000000000000000000000000000000000000000000000000000000000000000000000000000000000000000000000000000000",
      "000000000000000000000000000000000000000000000000000000000000000000000000000000000000000000000000000000000000000000000000",
      "000000000000000000000000000000000000000000000000000000000000000000000000000000000000000000000000000000000000000000000000",
      "000000000000000000000000000000000000000000000000000000000000000000000000000000000000000000000000000000000000000000000000",
      "000000000000000000000000000000000000000000000000000000000000000000000000000000000000000000000000000000000000000000000000",
      "000000000000000000000000000000000000000000000000000000000000000000000000000000000000000000000000000000000000000000000000",
      "000000000000000000000000000000000000000000000000000000000000000000000000000000000000000000000000000000000000000000000000",
      "000000000000000000000000000000000000000000000000000000000000000000000000000000000000000000000000000000000000000000000000",
      "000000000000000000000000000000000000000000000000000000000000000000000000000000000000000000000000000000000000000000000000",
      "000000000000000000000000000000000000000000000000000000000000000000000000000000000000000000000000000000000000000000000000",
      "000000000000000000000000000000000000000000000000000000000000000000000000000000000000000000000000000000000000000000000000",
      "000000000000000000000000000000000000000000000000000000000000000000000000000000000000000000000000000000000000000000000000",
      "000000000000000000000000000000000000000000000000000000000000000000000000000000000000000000000000000000000000000000000000",
      "000000000000000000000000000000000000000000000000000000000000000000000000000000000000000000000000000000000000000000000000",
      "000000000000000000000000000000000000000000000000000000000000000000000000000000000000000000000000000000000000000000000000",
      "000000000000000000000000000000000000000000000000000000000000000000000000000000000000000000000000000000000000000000000000",
      "000000000000000000000000000000000000000000000000000000000000000000000000000000000000000000000000000000000000000000000000",
      "000000000000000000000000000000000000000000000000000000000000000000000000000000000000000000000000000000000000000000000000",
      "000000000000000000000000000000000000000000000000000000000000000000000000000000000000000000000000000000000000000000000000",
      "000000000000000000000000000000000000000000000000000000000000000000000000000000000000000000000000000000000000000000000000",
      "000000000000000000000000000000000000000000000000000000000000000000000000000000000000000000000000000000000000000000000000",
      "000000000000000000000000000000000000000000000000000000000000000000000000000000000000000000000000000000000000000000000000",
      "000000000000000000000000000000000000000000000000000000000000000000000000000000000000000000000000000000000000000000000000",
      "000000000000000000000000000303000000000000000000000000000000000000000000000000000000000000000000000000000000000000000000",
      "000000000000000000000000000303000000000000000000000000000000000000000000000000000000000000000000000000000000000000000000",
      "000000000000000000000000000333000000000000000000000000000000000000000000000000000000000000000000000000000000000000000000",
      "000000000000000000000000000000000000000000000000000000000000000000000000000000000000000000000000000000000000000000000000",
      "000000000000000000000000000000000000000000000000000000000000000000000000000000000000000000000000000000000000000000000000",
      "000000000000000000000000000000000000000000000000000000000000000000000000000000000000000000000000000000000000000000000000",
      "000000000000000000000000000000000000000000000000000000000000000000000000000000000000000000000000000000000000000000000000",
      "000000000000000000000000000000000000000000000000000000000000000000000000000000000000000000000000000000000000000000000000",
      "000000000000000000000000000000000000000000000000000000000000000000000000000000000000000000000000000000000000000000000000",
      "000000000000000000000000000000000000000000000000000000000000000000000000000000000000000000000000000000000000000000000000",
      "000000000000000000000000000000000000000000000000000000000000000000000000000000000000000000000000000000000000000000000000",
      "000000000000000000000000000000000000000000000000000000000000000000000000000000000000000000000000000000000000000000000000",
      "000000000000000000000000000000000000000000000000000000000000000000000000000000000000000000000000000000000000000000000000",
      "000000000000000000000000000000000000000000000000000000000000000000000000000000000000000000000000000000000000000000000000",
      "000000000000000000000000000000000000000000000000000000000000000000000000000000000000000000000000000000000000000000000000",
      "000000000000000000000000000000000000000000000000000000000000000000000000000000000000000000000000000000000000000000000000"
    ],
    "sheet_id": 1003
  },
  "entities": [
    {
      "id": 1727515759,
      "frame": {
        "x": 28,
        "y": 65,
        "w": 1,
        "h": 1
      },
      "name": "Deep Hole",
      "species_id": 5001,
      "entity_type": "Teleporter",
      "offset": {
        "x": 0.0,
        "y": 0.0
      },
      "direction": 1,
      "current_speed": 0.0,
      "is_rigid": false,
      "z_index": 0,
      "sprite": {
        "sheet_id": 1010,
        "frame": {
          "x": 1,
          "y": 3,
          "w": 1,
          "h": 1
        },
        "number_of_frames": 1
      },
      "dialogues": {
        "options": []
      },
      "time_immobilized": 0.0,
      "destination": {
        "world": 1003,
        "x": 60,
        "y": 7
      },
      "lock_type": "None",
      "original_sprite_frame": {
        "x": 1,
        "y": 3,
        "w": 1,
        "h": 1
      },
      "speed_multiplier": 1.0,
      "melee_attacks_hero": false,
      "is_dying": false,
      "patrol": {
        "initial_position": [
          0,
          0
        ],
        "current_index": 0,
        "movements": []
      },
      "latest_movement": [
        0,
        0
      ],
      "contents": null,
      "remaining_lifespan": -420.0,
      "shooting_cooldown_remaining": 0.0,
      "parent_id": 0,
      "is_invulnerable": true,
      "demands_attention": false
    }
  ],
  "creep_spawn_enabled": false,
  "creep_spawn_interval": 0.0,
  "is_interior": false
}