{
  "id": 1005,
  "biome_tiles": {
    "tiles": [
      "000000000000000000000000000000000000000000000000000000000000000000000000000000000000000000000000000000000000000000000000",
      "000000000000000000000000000000000000000000000000000000000000000000000000000000000000000000000000000000000000000000000000",
      "000000000000000000000000000000000000000000000000000000000000000000000000000000000000000000000000000000000000000000000000",
      "000000000000000000000000000000000000000000000000000000000000000000000000000000000000000000000000000000000000000000000000",
      "000000000000000000000000000000000000000000000000000000000000000000000000000000000000000000000000000000000000000000000000",
      "000000000000000000000000000000000000000000000000000000000000000000000000000000000000000000000000000000000000000000000000",
      "000000000000000000000000000000000000000000000000000000000000000000000000000000000000000000000000000000000000000000000000",
      "000000000000000000000000000000000000000000000000000000000000000000000000000000000000000000000000000000000000000000000000",
      "000000000000000000000000000000000000000000000000000000000000000000000000000000000000000000000000000000000000000000000000",
      "000000000000000000000000000000000000000000000000000000000000000000000000000000000000000000000000000000000000000000000000",
      "000000000000000000000000000000000000000000000000000000000000000000000000000000000000000000000000000000000000000000000000",
      "000000000000000000000000000000000000000000000000000000000000000000000000000000000000000000000000000000000000000000000000",
      "000000000000000000000000000000000000000000000000000000000000000000000000000000000000000000000000000000000000000000000000",
      "000000000000000000000000000000000000000000000000000000000000000000000000000000000000000000000000000000000000000000000000",
      "000000000000000000000000000000000000000000000000000000000000000000000000000000000000000000000000000000000000000000000000",
      "000000000000000000000000000000000000000000000000000000000000000000000000000000000000000000000000000000000000000000000000",
      "000000000000000000000000000000000000000000000000000000000000000000000000000000000000000000000000000000000000000000000000",
      "000000000000000000000000000000000000000000000000000000000000000000000000000000000000000000000000000000000000000000000000",
      "000000000000000000000000000000000000000000000000000000000000000000000000000000000000000000000000000000000000000000000000",
      "000000000000000000000000000000000000000000000000000000000000000000000000000000000000000000000000000000000000000000000000",
      "000000000000000000000000000000000000000000000000000000000000000000000000000000000000000000000000000000000000000000000000",
      "000000000000000000000000000000000000000000000000000000000000000000000000000000000000000000000000000000000000000000000000",
      "000000000000000000000000000000000000000000000000000000000000000000000000000000000000000000000000000000000000000000000000",
      "000000000000000000000000000000000000000000000000000000000000000000000000000000000000000000000000000000000000000000000000",
      "000000000000000000000000000000000000000000000000000000000000000000000000000000000000000000000000000000000000000000000000",
      "000000000000000000000000000000000000000000000000000000000000000000000000000000000000000000000000000000000000000000000000",
      "000000000000000000000000000000000000000000000000000000000000000000000000000000000000000000000000000000000000000000000000",
      "000000000000000000000000000000000000000000000000000000000000000000000000000000000000000000000000000000000000000000000000",
      "000000000000000000000000000000000000000000000000000000000000000000000000000000000000000000000000000000000000000000000000",
      "000000000000000000000000000000000000000000000000000000000000000000000000000000000000000000000000000000000000000000000000",
      "000000000000000000000000000000000000000000000000000000000000000000000000000000000000000000000000000000000000000000000000",
      "000000000000000000000000000000000000000000000000000000000000000000000000000000000000000000000000000000000000000000000000",
      "00000000000000000000000000000000000000000000BBBBBBBBBBBBBBBBBBBBBBBB0000000000000000000000000000000000000000000000000000",
      "00000000000000000000000000000000000000000000BBBBBBBBBBBBBBBBBBBBBBBB0000000000000000000000000000000000000000000000000000",
      "00000000000000000000000000000000000000000000BBBBBBBBBBBBBBBBBBBBBBBB0000000000000000000000000000000000000000000000000000",
      "00000000000000000000000000000000000000000000BBBBBBBBBBBBBBBBBBBBBBBB0000000000000000000000000000000000000000000000000000",
      "00000000000000000000000000000000000000000000BBBBBBBBBBBBBBBBBBBBBBBB0000000000000000000000000000000000000000000000000000",
      "00000000000000000000000000000000000000000000BBBBBBBBBBBBBBBBBBBBBBBB0000000000000000000000000000000000000000000000000000",
      "00000000000000000000000000000000000000000000BBBBBBBBBBBBBBBBBBBBBBBB0000000000000000000000000000000000000000000000000000",
      "00000000000000000000000000000000000000000000BBBBBBBBBBBBBBBBBBBBBBBB0000000000000000000000000000000000000000000000000000",
      "00000000000000000000000000000000000000000000BBBBBBBBBBBBBBBBBBBBBBBB0000000000000000000000000000000000000000000000000000",
      "00000000000000000000000000000000000000000000BBBBBBBBBBBBBBBBBBBBBBBB0000000000000000000000000000000000000000000000000000",
      "00000000000000000000000000000000000000000000BBBBBBBBBBBBBBBBBBBBBBBB0000000000000000000000000000000000000000000000000000",
      "00000000000000000000000000000000000000000000BBBBBBBBBBBBBBBBBBBBBBBB0000000000000000000000000000000000000000000000000000",
      "00000000000000000000000000000000000000000000BBBBBBBBBBBBBBBBBBBBBBBB0000000000000000000000000000000000000000000000000000",
      "00000000000000000000000000000000000000000000BBBBBBBBBBBBBBBBBBBBBBBB0000000000000000000000000000000000000000000000000000",
      "000000000000000000000000000000000000000000000000000000000000000000000000000000000000000000000000000000000000000000000000",
      "000000000000000000000000000000000000000000000000000000000000000000000000000000000000000000000000000000000000000000000000",
      "000000000000000000000000000000000000000000000000000000000000000000000000000000000000000000000000000000000000000000000000",
      "000000000000000000000000000000000000000000000000000000000000000000000000000000000000000000000000000000000000000000000000",
      "000000000000000000000000000000000000000000000000000000000000000000000000000000000000000000000000000000000000000000000000",
      "000000000000000000000000000000000000000000000000000000000000000000000000000000000000000000000000000000000000000000000000",
      "000000000000000000000000000000000000000000000000000000000000000000000000000000000000000000000000000000000000000000000000",
      "000000000000000000000000000000000000000000000000000000000000000000000000000000000000000000000000000000000000000000000000",
      "000000000000000000000000000000000000000000000000000000000000000000000000000000000000000000000000000000000000000000000000",
      "000000000000000000000000000000000000000000000000000000000000000000000000000000000000000000000000000000000000000000000000",
      "000000000000000000000000000000000000000000000000000000000000000000000000000000000000000000000000000000000000000000000000",
      "000000000000000000000000000000000000000000000000000000000000000000000000000000000000000000000000000000000000000000000000",
      "000000000000000000000000000000000000000000000000000000000000000000000000000000000000000000000000000000000000000000000000",
      "000000000000000000000000000000000000000000000000000000000000000000000000000000000000000000000000000000000000000000000000",
      "000000000000000000000000000000000000000000000000000000000000000000000000000000000000000000000000000000000000000000000000",
      "000000000000000000000000000000000000000000000000000000000000000000000000000000000000000000000000000000000000000000000000",
      "000000000000000000000000000000000000000000000000000000000000000000000000000000000000000000000000000000000000000000000000",
      "000000000000000000000000000000000000000000000000000000000000000000000000000000000000000000000000000000000000000000000000",
      "000000000000000000000000000000000000000000000000000000000000000000000000000000000000000000000000000000000000000000000000",
      "000000000000000000000000000000000000000000000000000000000000000000000000000000000000000000000000000000000000000000000000",
      "000000000000000000000000000000000000000000000000000000000000000000000000000000000000000000000000000000000000000000000000",
      "000000000000000000000000000000000000000000000000000000000000000000000000000000000000000000000000000000000000000000000000",
      "000000000000000000000000000000000000000000000000000000000000000000000000000000000000000000000000000000000000000000000000",
      "000000000000000000000000000000000000000000000000000000000000000000000000000000000000000000000000000000000000000000000000",
      "000000000000000000000000000000000000000000000000000000000000000000000000000000000000000000000000000000000000000000000000",
      "000000000000000000000000000000000000000000000000000000000000000000000000000000000000000000000000000000000000000000000000",
      "000000000000000000000000000000000000000000000000000000000000000000000000000000000000000000000000000000000000000000000000",
      "000000000000000000000000000000000000000000000000000000000000000000000000000000000000000000000000000000000000000000000000",
      "000000000000000000000000000000000000000000000000000000000000000000000000000000000000000000000000000000000000000000000000",
      "000000000000000000000000000000000000000000000000000000000000000000000000000000000000000000000000000000000000000000000000",
      "000000000000000000000000000000000000000000000000000000000000000000000000000000000000000000000000000000000000000000000000",
      "000000000000000000000000000000000000000000000000000000000000000000000000000000000000000000000000000000000000000000000000",
      "000000000000000000000000000000000000000000000000000000000000000000000000000000000000000000000000000000000000000000000000",
      "000000000000000000000000000000000000000000000000000000000000000000000000000000000000000000000000000000000000000000000000"
    ],
    "sheet_id": 1002
  },
  "constructions_tiles": {
    "tiles": [
      "000000000000000000000000000000000000000000000000000000000000000000000000000000000000000000000000000000000000000000000000",
      "000000000000000000000000000000000000000000000000000000000000000000000000000000000000000000000000000000000000000000000000",
      "000000000000000000000000000000000000000000000000000000000000000000000000000000000000000000000000000000000000000000000000",
      "000000000000000000000000000000000000000000000000000000000000000000000000000000000000000000000000000000000000000000000000",
      "000000000000000000000000000000000000000000000000000000000000000000000000000000000000000000000000000000000000000000000000",
      "000000000000000000000000000000000000000000000000000000000000000000000000000000000000000000000000000000000000000000000000",
      "000000000000000000000000000000000000000000000000000000000000000000000000000000000000000000000000000000000000000000000000",
      "000000000000000000000000000000000000000000000000000000000000000000000000000000000000000000000000000000000000000000000000",
      "000000000000000000000000000000000000000000000000000000000000000000000000000000000000000000000000000000000000000000000000",
      "000000000000000000000000000000000000000000000000000000000000000000000000000000000000000000000000000000000000000000000000",
      "000000000000000000000000000000000000000000000000000000000000000000000000000000000000000000000000000000000000000000000000",
      "000000000000000000000000000000000000000000000000000000000000000000000000000000000000000000000000000000000000000000000000",
      "000000000000000000000000000000000000000000000000000000000000000000000000000000000000000000000000000000000000000000000000",
      "000000000000000000000000000000000000000000000000000000000000000000000000000000000000000000000000000000000000000000000000",
      "000000000000000000000000000000000000000000000000000000000000000000000000000000000000000000000000000000000000000000000000",
      "000000000000000000000000000000000000000000000000000000000000000000000000000000000000000000000000000000000000000000000000",
      "000000000000000000000000000000000000000000000000000000000000000000000000000000000000000000000000000000000000000000000000",
      "000000000000000000000000000000000000000000000000000000000000000000000000000000000000000000000000000000000000000000000000",
      "000000000000000000000000000000000000000000000000000000000000000000000000000000000000000000000000000000000000000000000000",
      "000000000000000000000000000000000000000000000000000000000000000000000000000000000000000000000000000000000000000000000000",
      "000000000000000000000000000000000000000000000000000000000000000000000000000000000000000000000000000000000000000000000000",
      "000000000000000000000000000000000000000000000000000000000000000000000000000000000000000000000000000000000000000000000000",
      "000000000000000000000000000000000000000000000000000000000000000000000000000000000000000000000000000000000000000000000000",
      "000000000000000000000000000000000000000000000000000000000000000000000000000000000000000000000000000000000000000000000000",
      "000000000000000000000000000000000000000000000000000000000000000000000000000000000000000000000000000000000000000000000000",
      "000000000000000000000000000000000000000000000000000000000000000000000000000000000000000000000000000000000000000000000000",
      "000000000000000000000000000000000000000000000000000000000000000000000000000000000000000000000000000000000000000000000000",
      "000000000000000000000000000000000000000000000000000000000000000000000000000000000000000000000000000000000000000000000000",
      "000000000000000000000000000000000000000000000000000000000000000000000000000000000000000000000000000000000000000000000000",
      "000000000000000000000000000000000000000000000000000000000000000000000000000000000000000000000000000000000000000000000000",
      "000000000000000000000000000000000000000000000000000000000000000000000000000000000000000000000000000000000000000000000000",
      "000000000000000000000000000000000000000000000000000000000000000000000000000000000000000000000000000000000000000000000000",
      "000000000000000000000000000000000000000000000000000000000000000000000000000000000000000000000000000000000000000000000000",
      "000000000000000000000000000000000000000000000000000000000000HHHHHHHH0000000000000000000000000000000000000000000000000000",
      "000000000000000000000000000000000000000000000000000000000000H00000000000000000000000000000000000000000000000000000000000",
      "000000000000000000000000000000000000000000000000000000000000HHHHHHH00000000000000000000000000000000000000000000000000000",
      "000000000000000000000000000000000000000000000000000000000000000000H00000000000000000000000000000000000000000000000000000",
      "000000000000000000000000000000000000000000000000000000000000000000H00000000000000000000000000000000000000000000000000000",
      "000000000000000000000000000000000000000000000000000000000000000000000000000000000000000000000000000000000000000000000000",
      "000000000000000000000000000000000000000000000000000000000000000000000000000000000000000000000000000000000000000000000000",
      "000000000000000000000000000000000000000000000000000000000000000000000000000000000000000000000000000000000000000000000000",
      "000000000000000000000000000000000000000000000000000000000000000000000000000000000000000000000000000000000000000000000000",
      "000000000000000000000000000000000000000000000000000000000000000000000000000000000000000000000000000000000000000000000000",
      "000000000000000000000000000000000000000000000000000000000000000000000000000000000000000000000000000000000000000000000000",
      "000000000000000000000000000000000000000000000000000000000000000000000000000000000000000000000000000000000000000000000000",
      "000000000000000000000000000000000000000000000000000000000000000000000000000000000000000000000000000000000000000000000000",
      "000000000000000000000000000000000000000000000000000000000000000000000000000000000000000000000000000000000000000000000000",
      "000000000000000000000000000000000000000000000000000000000000000000000000000000000000000000000000000000000000000000000000",
      "000000000000000000000000000000000000000000000000000000000000000000000000000000000000000000000000000000000000000000000000",
      "000000000000000000000000000000000000000000000000000000000000000000000000000000000000000000000000000000000000000000000000",
      "000000000000000000000000000000000000000000000000000000000000000000000000000000000000000000000000000000000000000000000000",
      "000000000000000000000000000000000000000000000000000000000000000000000000000000000000000000000000000000000000000000000000",
      "000000000000000000000000000000000000000000000000000000000000000000000000000000000000000000000000000000000000000000000000",
      "000000000000000000000000000000000000000000000000000000000000000000000000000000000000000000000000000000000000000000000000",
      "000000000000000000000000000000000000000000000000000000000000000000000000000000000000000000000000000000000000000000000000",
      "000000000000000000000000000000000000000000000000000000000000000000000000000000000000000000000000000000000000000000000000",
      "000000000000000000000000000000000000000000000000000000000000000000000000000000000000000000000000000000000000000000000000",
      "000000000000000000000000000000000000000000000000000000000000000000000000000000000000000000000000000000000000000000000000",
      "000000000000000000000000000000000000000000000000000000000000000000000000000000000000000000000000000000000000000000000000",
      "000000000000000000000000000000000000000000000000000000000000000000000000000000000000000000000000000000000000000000000000",
      "000000000000000000000000000000000000000000000000000000000000000000000000000000000000000000000000000000000000000000000000",
      "000000000000000000000000000000000000000000000000000000000000000000000000000000000000000000000000000000000000000000000000",
      "000000000000000000000000000000000000000000000000000000000000000000000000000000000000000000000000000000000000000000000000",
      "000000000000000000000000000000000000000000000000000000000000000000000000000000000000000000000000000000000000000000000000",
      "000000000000000000000000000000000000000000000000000000000000000000000000000000000000000000000000000000000000000000000000",
      "000000000000000000000000000000000000000000000000000000000000000000000000000000000000000000000000000000000000000000000000",
      "000000000000000000000000000000000000000000000000000000000000000000000000000000000000000000000000000000000000000000000000",
      "000000000000000000000000000000000000000000000000000000000000000000000000000000000000000000000000000000000000000000000000",
      "000000000000000000000000000000000000000000000000000000000000000000000000000000000000000000000000000000000000000000000000",
      "000000000000000000000000000000000000000000000000000000000000000000000000000000000000000000000000000000000000000000000000",
      "000000000000000000000000000000000000000000000000000000000000000000000000000000000000000000000000000000000000000000000000",
      "000000000000000000000000000000000000000000000000000000000000000000000000000000000000000000000000000000000000000000000000",
      "000000000000000000000000000000000000000000000000000000000000000000000000000000000000000000000000000000000000000000000000",
      "000000000000000000000000000000000000000000000000000000000000000000000000000000000000000000000000000000000000000000000000",
      "000000000000000000000000000000000000000000000000000000000000000000000000000000000000000000000000000000000000000000000000",
      "000000000000000000000000000000000000000000000000000000000000000000000000000000000000000000000000000000000000000000000000",
      "000000000000000000000000000000000000000000000000000000000000000000000000000000000000000000000000000000000000000000000000",
      "000000000000000000000000000000000000000000000000000000000000000000000000000000000000000000000000000000000000000000000000",
      "000000000000000000000000000000000000000000000000000000000000000000000000000000000000000000000000000000000000000000000000",
      "000000000000000000000000000000000000000000000000000000000000000000000000000000000000000000000000000000000000000000000000"
    ],
    "sheet_id": 1003
  },
  "entities": [],
  "creep_spawn_enabled": false,
  "creep_spawn_interval": 0.0,
  "is_interior": false
}