{
  "id": 1005,
  "biome_tiles": {
    "tiles": [
      "222222222222222222222222222222222222222222222222222222222222222222222222222222222222222222222222222222222222222222222222",
      "222222222222222222222222222222222222222222222222222222222222222222222222222222222222222222222222222222222222222222222222",
      "222222222222222222222222222222222222222222222224444222222222444222222444444422222222222222222222222222222222222222222222",
      "222222222222222222222224422222444442222444242444444444242444444444444444444442222222222222222222222222222222222222222222",
      "222222222222222222222222422222444444424444444444111444444444411444444411111444222222222222222222222222222222222222222222",
      "222222222222222222222244442224441114444411444411111111444411111111111111111144222224422222222222222222222222222222222222",
      "222222222222222222222444442222441111144111111111111111111111111111111111111144444444222222222222222222222222222222222222",
      "222222222222222222244441444444441111111111111111111111111111111111111111111111444444422222222242222222222222222222222222",
      "222222222222222224444411114444411111111111111111111111111111111111111111111111111144222222224442222222222222222222222222",
      "222222222222222224441111111111111111111111111111111111111111111111111111111111111144442222224442222222222222222222222222",
      "222222222222244444411111111111111111111111111111111111111111111111111111111111111111444444444442222222222222222222222222",
      "222222222222444444111111111111111111111111111111111111111111111111111111111111111111114444444444242222222222222222222222",
      "222222222222441111111111111111111111111111111111111111111111111111111111111111111111111111111144444222222222222222222222",
      "222222222222244111111111111111111111111111111111111111111111111111111111111111111111111111111111444222222222222222222222",
      "222222222222444111111111111111111111111111111111111111111111111111111111111111111111111111111111144222242222222222222222",
      "222222222444441111111111111111111111111111111111111111111111111111111111111111111111111111111111144422244222222222222222",
      "222222222444411111111111111111111111111111111111111111111111111111111111111111111111111111111111114442444422222222222222",
      "222222222441111111111111111111111111111111111111111111111111111111111111111111111111111111111111111444444422222222222222",
      "222222222441111111111111111111111111111111111111111111111111111111111111111111111111111111111111111114414442222222222222",
      "222222222244111111111111111111111111111111111111111111111111111111111111111111111111111111111111111111111444222222222222",
      "222222222444111111111111111111111111111111111111111111111111111111111111111111111111111111111111111111111144422222222222",
      "222442222441111111111111111111111111111111111111111111111111111111111111111111111111111111111111111111111114422222222222",
      "222444224441111111111111111111111111111111111111111111111111111111111111111111111111111111111111111111111114444244422222",
      "222444444411111111111111111111111111111111111111111111111111111111111111111111111111111111111111111111111111144444422222",
      "222244444111111111111111111111111111111111111111111111111111111111111111111111111111111111111111111111111111111444442222",
      "222444111111111111111111111111111111111111111111111111111111111111111111111111111111111111111111111111111111111114422222",
      "222441111111111111111111111111111111111111111111111111111111111111111111111111111111111111111111111111111111111114442222",
      "222441111111111111111111111111111111111111111111111111111111111111111111111111111111111111111111111111111111111114422222",
      "222441111111111111111111111111111111111111111111111111111111111111111111111111111111111111111111111111111111111114442222",
      "222244111111111111111111111111111111111111111111111111111111111111111111111111111111111111111111111111111111111111442222",
      "222244111111111111111111111111111111111111111111111111111111111111111111111111111111111111111111111111111111111111444222",
      "222444111111111111111111111111111111111111111111111111111111111111111111111111111111111111111111111111111111111111144222",
      "224441111111111111111111111111111111111111111111111111111111111111111111111111111111111111111111111111111111111111144422",
      "224411111111111111111111111111111111111111111111111111111111111111111111111111111111111111111111111111111111111111144222",
      "224411111111111111111111111111111111111111111111111111111111111111111111111111111111111111111111111111111111111111144422",
      "224411111111111111111111111111111111111111111111111111111111111111111111111111111111111111111111111111111111111111144222",
      "224411111111111111111111111111111111111111111111111111111111111111111111111111111111111111111111111111111111111111144222",
      "224411111111111111111111111111111111111111111111111111111111111111111111111111111111111111111111111111111111111111144222",
      "224411111111111111111111111111111111111111111111111111111111111111111111111111111111111111111111111111111111111111144222",
      "224411111111111111111111111111111111111111111111111111111111111111111111111111111111111111111111111111111111111111144222",
      "222441111111111111111111111111111111111111111111111111111111111111111111111111111111111111111111111111111111111111144222",
      "224441111111111111111111111111111111111111111111111111111111111111111111111111111111111111111111111111111111111111144222",
      "222441111111111111111111111111111111111111111111111111111111111111111111111111111111111111111111111111111111111111144222",
      "224441111111111111111111111111111111111111111111111111111111111111111111111111111111111111111111111111111111111111144222",
      "222441111111111111111111111111111111111111111111111111111111111111111111111111111111111111111111111111111111111111144222",
      "222441111111111111111111111111111111111111111111111111111111111111111111111111111111111111111111111111111111111111144422",
      "222244111111111111111111111111111111111111111111111111111111111111111111111111111111111111111111111111111111111111114422",
      "222444111111111111111111111111111111111111111111111111111111111111111111111111111111111111111111111111111111111111114422",
      "222244111111111111111111111111111111111111111111111111111111111111111111111111111111111111111111111111111111111111114422",
      "222444111111111111111111111111111111111111111111111111111111111111111111111111111111111111111111111111111111111111144222",
      "222441111111111111111111111111111111111111111111111111111111111111111111111111111111111111111111111111111111111111144222",
      "224441111111111111111111111111111111111111111111111111111111111111111111111111111111111111111111111111111111111111144222",
      "224411111111111111111111111111111111111111111111111111111111111111111111111111111111111111111111111111111111111111144222",
      "244411111111111111111111111111111111111111111111111111111111111111111111111111111111111111111111111111111111111444444222",
      "222444411111111111111111111111111111111111111111111111111111111111111111111111111111111111111111111111111111114444444222",
      "224444411111111111111111111111111111111111111111111111111111111111111111111111111111111111111111111111111111144242422222",
      "222222441111111111111111111111111111111111111111111111111111111111111111111111111111111111111111111111111111144222222222",
      "222224441111111111111111111111111111111111111111111111111111111111111111111111111111111111111111111111111111144222222222",
      "222222441111111111111111111111111111111111111111111111111111111111111111111111111111111111111111111111111111144422222222",
      "222222441111111111111111111111111111111111111111111111111111111111111111111111111111111111111111111111111111114422222222",
      "222222244111111111111111111111111111111111111111111111111111111111111111111111111111111111111111111111111111114422222222",
      "222222244411111111111111111111111111111111111111111111111111111111111111111111111111111111111111111111111111144222222222",
      "222222224441111111111111111111111111111111111111111111111111111111111111111111111111111111111111111111111111442222222222",
      "222222222444444411111111111111111111111111111111111111111111111111111111111111111111111111111111111111114444442222222222",
      "222222222244444411111111111111111111111111111111111111111111111111111111111111111111111111111111111111444444222222222222",
      "222222222224222441111111111111111111111111111111111111111111111111111111111111111111111111111111111114442224222222222222",
      "222222222222224444111111111111111111111111111111111111111111111111111111111111111111111111111111111144242222222222222222",
      "222222222222222444444111111111111111111111111111111111111111111111111111111111111111111111111441111442222222222222222222",
      "222222222222222424444441144441111111111111111111111111111111111111111111111111111111111111114444414422222222222222222222",
      "222222222222222224224441444441111111111111111111111111111111111111111111111111111111111111144244444222222222222222222222",
      "222222222222222222244244422244111111111111111111111111111111111111111111111111111111111111442222442222222222222222222222",
      "222222222222222422222244222244111111111111111111111111111111111111111111111111111111111111444222222222222222222222222222",
      "222222222222222222222222222244111111111111111111111111111111111111111111111111111111111444442222222222222222222222222222",
      "222222222222222222222224222244111111111111111111111111111111111111111111111111111111444444222222222222222222222222222222",
      "222222222222222222222222222224444411111111111111111144111111111111111111114444114444444222222222222222222222222222222222",
      "222222222222222222222424222244444444111111111444444444444111111111111144444444444444222222222222222222222222222222222222",
      "222222222222222222244222222222222444444444444444444424444444444444444444442424442422222222222222222222222222222222222222",
      "222222222222222222222222222222222224444444444242422222224444444444444424222222222222222222222222222222222222222222222222",
      "222222222222222222222222222222222222222222222222222222222222222222222222222222222222222222222222222222222222222222222222",
      "222222222222222222222222222222222222222222222222222222222222222222222222222222222222222222222222222222222222222222222222"
    ],
    "sheet_id": 1002
  },
  "constructions_tiles": {
    "tiles": [
      "000000000000000000000000000000000000000000000000000000000000000000000000000000000000000000000000000000000000000000000000",
      "000000000000000000000000000000000000000000000000000000000000000000000000000000000000000000000000000000000000000000000000",
      "000000000000000000000000000000000000000000000000000000000000000000000000000000000000000000000000000000000000000000000000",
      "000000000000000000000000000000000000000000000000000000000000000000000000000000000000000000000000000000000000000000000000",
      "000000000000000000000000000000000000000000000000000000000000000000000000000000000000000000000000000000000000000000000000",
      "000000000000000000000000000000000000000000000000000000000000000000000000000000000000000000000000000000000000000000000000",
      "000000000000000000000000000000000000000000000000000000000000000000000000000000000000000000000000000000000000000000000000",
      "000000000000000000000000000000000000000000000000000000000000000000000000000000000000000000000000000000000000000000000000",
      "000000000000000000000000000000000000000000000000000000000000000000000000000000000000000000000000000000000000000000000000",
      "000000000000000000000000000000000000000000000000000000000000000000000000000000000000000000000000000000000000000000000000",
      "000000000000000000000000000000000000000000000000000000000000000000000000000000000000000000000000000000000000000000000000",
      "000000000000000000000000000000000000000000000000000000000000000000000000000000000000000000000000000000000000000000000000",
      "000000000000000000000000000000000000000000000000000000000000000000000000000000000000000000000000000000000000000000000000",
      "000000000000000000000000000000000000000000000000000000000000000000000000000000000000000000000000000000000000000000000000",
      "000000000000000000000000000000000000000000000000000000000000000000000000000000000000000000000000000000000000000000000000",
      "000000000000000000000000000000000000000000000000000000000000000000000000000000000000000000000000000000000000000000000000",
      "000000000000000000000000000000000000000000000000000000000000000000000000000000000000000000000000000000000000000000000000",
      "000000000000000000000000000000000000000000000000000000000000000000000000000000000000000000000000000000000000000000000000",
      "000000000000000000000000000000000000000000000000000000000000000000000000000000000000000000000000000000000000000000000000",
      "000000000000000000000000000000000000000000000000000000000000000000000000000000000000000000000000000000000000000000000000",
      "000000000000000000000000000000000000000000000000000000000000000000000000000000000000000000000000000000000000000000000000",
      "000000000000000000000000000000000000000000000000000000000000000000000000000000000000000000000000000000000000000000000000",
      "000000000000000000000000000000000000000000000000000000000000000000000000000000000000000000000000000000000000000000000000",
      "000000000000000000000000000000000000000000000000000000000000000000000000000000000000000000000000000000000000000000000000",
      "000000000000000000000000000000000000000000000000000000000000000000000000000000000000000000000000000000000000000000000000",
      "000000000000000000000000000000000000000000000000000000000000000000000000000000000000000000000000000000000000000000000000",
      "000000000000000000000000000000000000000000000000000000000000000000000000000000000000000000000000000000000000000000000000",
      "000000000000000000000000000000000000000000000000000000000000000000000000000000000000000000000000000000000000000000000000",
      "000000000000000000000000000000000000000000000000000000000000000000000000000000000000000000000000000000000000000000000000",
      "000000000000000000000000000000000000000000000000000000000000000000000000000000000000000000000000000000000000000000000000",
      "000000000000000000000000000000000000000000000000000000000000000000000000000000000000000000000000000000000000000000000000",
      "000000000000000000000000000000000000000000000000000000000000000000000000000000000000000000000000000000000000000000000000",
      "000000000000000000000000000000000000000000000000000000000000000000000000000000000000000000000000000000000000000000000000",
      "000000000000000000000000000000000000000000000000000000000000000000000000000000000000000000000000000000000000000000000000",
      "000000000000000000000000000000000000000000000000000000000000000000000000000000000000000000000000000000000000000000000000",
      "000000000000000000000000000000000000000000000000000000000000000000000000000000000000000000000000000000000000000000000000",
      "000000000000000000000000000000000000000000000000000000000000000000000000000000000000000000000000000000000000000000000000",
      "000000000000000000000000000000000000000000000000000000000000000000000000000000000000000000000000000000000000000000000000",
      "000000000000000000000000000000000000000000000000000000000000000000000000000000000000000000000000000000000000000000000000",
      "000000000000000000000000000000000000000000000000000000000000000000000000000000000000000000000000000000000000000000000000",
      "000000000000000000000000000000000000000000000000000000000000000000000000000000000000000000000000000000000000000000000000",
      "000000000000000000000000000000000000000000000000000000000000000000000000000000000000000000000000000000000000000000000000",
      "000000000000000000000000000000000000000000000000000000000000000000000000000000000000000000000000000000000000000000000000",
      "000000000000000000000000000000000000000000000000000000000000000000000000000000000000000000000000000000000000000000000000",
      "000000000000000000000000000000000000000000000000000000000000000000000000000000000000000000000000000000000000000000000000",
      "000000000000000000000000000000000000000000000000000000000000000000000000000000000000000000000000000000000000000000000000",
      "000000000000000000000000000000000000000000000000000000000000000000000000000000000000000000000000000000000000000000000000",
      "000000000000000000000000000000000000000000000000000000000000000000000000000000000000000000000000000000000000000000000000",
      "000000000000000000000000000000000000000000000000000000000000000000000000000000000000000000000000000000000000000000000000",
      "000000000000000000000000000000000000000000000000000000000000000000000000000000000000000000000000000000000000000000000000",
      "000000000000000000000000000000000000000000000000000000000000000000000000000000000000000000000000000000000000000000000000",
      "000000000000000000000000000000000000000000000000000000000000000000000000000000000000000000000000000000000000000000000000",
      "000000000000000000000000000000000000000000000000000000000000000000000000000000000000000000000000000000000000000000000000",
      "000000000000000000000000000000000000000000000000000000000000000000000000000000000000000000000000000000000000000000000000",
      "000000000000000000000000000000000000000000000000000000000000000000000000000000000000000000000000000000000000000000000000",
      "000000000000000000000000000000000000000000000000000000000000000000000000000000000000000000000000000000000000000000000000",
      "000000000000000000000000000000000000000000000000000000000000000000000000000000000000000000000000000000000000000000000000",
      "000000000000000000000000000000000000000000000000000000000000000000000000000000000000000000000000000000000000000000000000",
      "000000000000000000000000000000000000000000000000000000000000000000000000000000000000000000000000000000000000000000000000",
      "000000000000000000000000000000000000000000000000000000000000000000000000000000000000000000000000000000000000000000000000",
      "000000000000000000000000000000000000000000000000000000000000000000000000000000000000000000000000000000000000000000000000",
      "000000000000000000000000000000000000000000000000000000000000000000000000000000000000000000000000000000000000000000000000",
      "000000000000000000000000000000000000000000000000000000000000000000000000000000000000000000000000000000000000000000000000",
      "000000000000000000000000000000000000000000000000000000000000000000000000000000000000000000000000000000000000000000000000",
      "000000000000000000000000000000000000000000000000000000000000000000000000000000000000000000000000000000000000000000000000",
      "000000000000000000000000000000000000000000000000000000000000000000000000000000000000000000000000000000000000000000000000",
      "000000000000000000000000000000000000000000000000000000000000000000000000000000000000000000000000000000000000000000000000",
      "000000000000000000000000000000000000000000000000000000000000000000000000000000000000000000000000000000000000000000000000",
      "000000000000000000000000000000000000000000000000000000000000000000000000000000000000000000000000000000000000000000000000",
      "000000000000000000000000000000000000000000000000000000000000000000000000000000000000000000000000000000000000000000000000",
      "000000000000000000000000000000000000000000000000000000000000000000000000000000000000000000000000000000000000000000000000",
      "000000000000000000000000000000000000000000000000000000000000000000000000000000000000000000000000000000000000000000000000",
      "000000000000000000000000000000000000000000000000000000000000000000000000000000000000000000000000000000000000000000000000",
      "000000000000000000000000000000000000000000000000000000000000000000000000000000000000000000000000000000000000000000000000",
      "000000000000000000000000000000000000000000000000000000000000000000000000000000000000000000000000000000000000000000000000",
      "000000000000000000000000000000000000000000000000000000000000000000000000000000000000000000000000000000000000000000000000",
      "000000000000000000000000000000000000000000000000000000000000000000000000000000000000000000000000000000000000000000000000",
      "000000000000000000000000000000000000000000000000000000000000000000000000000000000000000000000000000000000000000000000000",
      "000000000000000000000000000000000000000000000000000000000000000000000000000000000000000000000000000000000000000000000000",
      "000000000000000000000000000000000000000000000000000000000000000000000000000000000000000000000000000000000000000000000000"
    ],
    "sheet_id": 1003
  },
  "entities": [],
  "creep_spawn_enabled": false,
  "creep_spawn_interval": 0.0,
  "is_interior": false
}