{
  "id": 1005,
  "biome_tiles": {
    "tiles": [
      "222222222222222222222222222222222222222222222222222222222222222222222222222222222222222222222222222222222222222222222222",
      "222222222222222222222222222222222222222222222222222222222222222222222222222222222222222222222222222222222222222222222222",
      "222222222222222222222222222222222222222224242422222222222244444444422222222222422222222222222222222222222222222222222222",
      "222222222222222222222222222222222222224444444444444444444444444444444222222224444222222222222222222222222222222222222222",
      "222222222222222222222222222222222222244444444444444444444441111111144442222224444422222222222222222222222222222222222222",
      "222222222222222222222222222224222222244111111111111111111111111111111444422224414444222222222222222222222222222222222222",
      "222222222222222222222222222244422222444111111111111111111111111111111114444244411144442222222244422222222222222222222222",
      "222222222222222222222222222244442224441111111111111111111111111111111111144444111111444222222222222222222222222222222222",
      "222222222222222222242222222444444444411111111111111111111111111111111111111441111111144222222244222222222222222222222222",
      "222222222222222222444422224441114444111111111111111111111111111111111111111111111111144442222222222222222222222222222222",
      "222222222222222224444442444411111111111111111111111111111111111111111111111111111111111444422244422222222222222222222222",
      "222222222222222222441444444111111111111111111111111111111111111111111111111111111111111114422222222222222222222222222222",
      "222222222224222222441114411111111111111111111111111111111111111111111111111111111111111114444444444444222222222222222222",
      "222222222244422224441111111111111111111111111111111111111111111111111111111111111111111111144444444444444222222222222222",
      "222222222244442244411111111111111111111111111111111111111111111111111111111111111111111111111111111111444442222222222222",
      "222222222444444444111111111111111111111111111111111111111111111111111111111111111111111111111111111111111442222222222222",
      "222222224441114441111111111111111111111111111111111111111111111111111111111111111111111111111111111111111444222222222222",
      "222222244411111111111111111111111111111111111111111111111111111111111111111111111111111111111111111111111144422222222222",
      "222224444111111111111111111111111111111111111111111111111111111111111111111111111111111111111111111111111114442222222222",
      "222244441111111111111111111111111111111111111111111111111111111111111111111111111111111111111111111111111111444442222222",
      "222244111111111111111111111111111111111111111111111111111111111111111111111111111111111111111111111111111111114442222222",
      "222444111111111111111111111111111111111111111111111111111111111111111111111111111111111111111111111111111111111444222222",
      "222441111111111111111111111111111111111111111111111111111111111111111111111111111111111111111111111111111111111144222222",
      "222441111111111111111111111111111111111111111111111111111111111111111111111111111111111111111111111111111111111144422222",
      "222441111111111111111111111111111111111111111111111111111111111111111111111111111111111111111111111111111111111114422222",
      "222441111111111111111111111111111111111111111111111111111111111111111111111111111111111111111111111111111111111114442222",
      "222441111111111111111111111111111111111111111111111111111111111111111111111111111111111111111111111111111111111111444222",
      "222441111111111111111111111111111111111111111111111111111111111111111111111111111111111111111111111111111111111111144222",
      "224441111111111111111111111111111111111111111111111111111111111111111111111111111111111111111111111111111111111111144222",
      "222441111111111111111111111111111111111111111111111111111111111111111111111111111111111111111111111111111111111111144422",
      "224441111111111111111111111111111111111111111111111111111111111111111111111111111111111111111111111111111111111111144222",
      "224411111111111111111111111111111111111111111111111111111111111111111111111111111111111111111111111111111111111111144422",
      "224411111111111111111111111111111111111111111111111111111111111111111111111111111111111111111111111111111111111111144222",
      "224411111111111111111111111111111111111111111111111111111111111111111111111111111111111111111111111111111111111111144222",
      "222441111111111111111111111111111111111111111111111111111111111111111111111111111111111111111111111111111111111111144222",
      "222441111111111111111111111111111111111111111111111111111111111111111111111111111111111111111111111111111111111111144222",
      "222441111111111111111111111111111111111111111111111111111111111111111111111111111111111111111111111111111111111111144222",
      "222441111111111111111111111111111111111111111111111111111111111111111111111111111111111111111111111111111111111111144222",
      "222441111111111111111111111111111111111111111111111111111111111111111111111111111111111111111111111111111111111111144222",
      "224441111111111111111111111111111111111111111111111111111111111111111111111111111111111111111111111111111111111111442222",
      "224411111111111111111111111111111111111111111111111111111111111111111111111111111111111111111111111111111111111111442222",
      "224411111111111111111111111111111111111111111111111111111111111111111111111111111111111111111111111111111111111111442222",
      "224411111111111111111111111111111111111111111111111111111111111111111111111111111111111111111111111111111111111111444222",
      "224411111111111111111111111111111111111111111111111111111111111111111111111111111111111111111111111111111111111111144222",
      "224411111111111111111111111111111111111111111111111111111111111111111111111111111111111111111111111111111111111111144422",
      "224411111111111111111111111111111111111111111111111111111111111111111111111111111111111111111111111111111111111111144222",
      "224411111111111111111111111111111111111111111111111111111111111111111111111111111111111111111111111111111111111111144422",
      "224411111111111111111111111111111111111111111111111111111111111111111111111111111111111111111111111111111111111111144222",
      "224411111111111111111111111111111111111111111111111111111111111111111111111111111111111111111111111111111111111114444422",
      "224411111111111111111111111111111111111111111111111111111111111111111111111111111111111111111111111111111111111444444222",
      "224411111111111111111111111111111111111111111111111111111111111111111111111111111111111111111111111111111111114442444422",
      "224411111111111111111111111111111111111111111111111111111111111111111111111111111111111111111111111111111111144222444222",
      "222441111111111111111111111111111111111111111111111111111111111111111111111111111111111111111111111111111111144222244222",
      "224441111111111111111111111111111111111111111111111111111111111111111111111111111111111111111111111111111111442222242222",
      "222444411111111111111111111111111111111111111111111111111111111111111111111111111111111111111111111111111114422222222222",
      "222444411111111111111111111111111111111111111111111111111111111111111111111111111111111111111111111111111114442222222222",
      "222222441111111111111111111111111111111111111111111111111111111111111111111111111111111111111111111111111111442222442222",
      "222222441111111111111111111111111111111111111111111111111111111111111111111111111111111111111111111111111111442222442222",
      "222222441111111111111111111111111111111111111111111111111111111111111111111111111111111111111111111111111111444222222222",
      "222224441111111111111111111111111111111111111111111111111111111111111111111111111111111111111111111111111114444222222222",
      "222222244111111111111111111111111111111111111111111111111111111111111111111111111111111111111111111111111144422222222222",
      "222224444111111111111111111111111111111111111111111111111111111111111111111111111111111111111111111111111442222222222222",
      "222222244111111111111111111111111111111111111111111111111111111111111111111111111111111111111111111144114442222222222222",
      "222224444111111111111111111111111111111111111111111111111111111111111111111111111111111111111111114444144242222222222222",
      "222222441111111111111111111111111111111111111111111111111111111111111111111111111111111111111111144424444242222222222222",
      "222222444444441111111111111111111111111111111111111111111111111111111111111111111111111111111111442224442222222222222222",
      "222222244444444111111111111111111111111111111111111111111111111111111111111111111111111111111111442222242222222222222222",
      "222222222222244111111111111111111111111111111111111111111111111111111111111111111111111111111111442222222222222222222222",
      "222222222222224411111111111111111111111111111111111111111111111111111111111111111111111111111111444222222222222222222222",
      "222222222222224414411111111111111111111111111111111111111111111111111111111111111111111111111114422222222222222222222222",
      "222222222222224444444111111111111111111111111111111111111111111111111111111111111114411111111144222222222222222222222222",
      "222222222222244442444111111111111111111111111111111111111111111111111111111111111444411111444444222222222222222222222222",
      "222222222222224442224411111111111111111111111111111111111111111111111111111111114442441144444442222222222222222222222222",
      "222222222222222222244411111111111111111111111111111111111111111111111111111111144222444444222222222222222222222222222222",
      "222222222222222222244444111111111111111111111144441111111111111111111111111111144222244422222222222222222222222222222222",
      "222222222222222222244444444441114444444444444444444411111111111111111114444444442222222222222222222222222222222222222222",
      "222222222222222222242424444444444444444444444424244444444444444444444444444444442222222222222222222222222222222222222222",
      "222222222222222222222222224244442222222222242222222444444444444444444442222222422222222222222222222222222222222222222222",
      "222222222222222222222222222222222222222222222222222222222222222422222222222222222222222222222222222222222222222222222222",
      "222222222222222222222222222222222222222222222222222222222222222222222222222222222222222222222222222222222222222222222222"
    ],
    "sheet_id": 1002
  },
  "constructions_tiles": {
    "tiles": [
      "000000000000000000000000000000000000000000000000000000000000000000000000000000000000000000000000000000000000000000000000",
      "000000000000000000000000000000000000000000000000000000000000000000000000000000000000000000000000000000000000000000000000",
      "000000000000000000000000000000000000000000000000000000000000000000000000000000000000000000000000000000000000000000000000",
      "000000000000000000000000000000000000000000000000000000000000000000000000000000000000000000000000000000000000000000000000",
      "000000000000000000000000000000000000000000000000000000000000000000000000000000000000000000000000000000000000000000000000",
      "000000000000000000000000000000000000000000000000000000000000000000000000000000000000000000000000000000000000000000000000",
      "000000000000000000000000000000000000000000000000000000000000000000000000000000000000000000000000000000000000000000000000",
      "000000000000000000000000000000000000000000000000000000000000000000000000000000000000000000000000000000000000000000000000",
      "000000000000000000000000000000000000000000000000000000000000000000000000000000000000000000000000000000000000000000000000",
      "000000000000000000000000000000000000000000000000000000000000000000000000000000000000000000000000000000000000000000000000",
      "000000000000000000000000000000000000000000000000000000000000000000000000000000000000000000000000000000000000000000000000",
      "000000000000000000000000000000000000000000000000000000000000000000000000000000000000000000000000000000000000000000000000",
      "000000000000000000000000000000000000000000000000000000000000000000000000000000000000000000000000000000000000000000000000",
      "000000000000000000000000000000000000000000000000000000000000000000000000000000000000000000000000000000000000000000000000",
      "000000000000000000000000000000000000000000000000000000000000000000000000000000000000000000000000000000000000000000000000",
      "000000000000000000000000000000000000000000000000000000000000000000000000000000000000000000000000000000000000000000000000",
      "000000000000000000000000000000000000000000000000000000000000000000000000000000000000000000000000000000000000000000000000",
      "000000000000000000000000000000000000000000000000000000000000000000000000000000000000000000000000000000000000000000000000",
      "000000000000000000000000000000000000000000000000000000000000000000000000000000000000000000000000000000000000000000000000",
      "000000000000000000000000000000000000000000000000000000000000000000000000000000000000000000000000000000000000000000000000",
      "000000000000000000000000000000000000000000000000000000000000000000000000000000000000000000000000000000000000000000000000",
      "000000000000000000000000000000000000000000000000000000000000000000000000000000000000000000000000000000000000000000000000",
      "000000000000000000000000000000000000000000000000000000000000000000000000000000000000000000000000000000000000000000000000",
      "000000000000000000000000000000000000000000000000000000000000000000000000000000000000000000000000000000000000000000000000",
      "000000000000000000000000000000000000000000000000000000000000000000000000000000000000000000000000000000000000000000000000",
      "000000000000000000000000000000000000000000000000000000000000000000000000000000000000000000000000000000000000000000000000",
      "000000000000000000000000000000000000000000000000000000000000000000000000000000000000000000000000000000000000000000000000",
      "000000000000000000000000000000000000000000000000000000000000000000000000000000000000000000000000000000000000000000000000",
      "000000000000000000000000000000000000000000000000000000000000000000000000000000000000000000000000000000000000000000000000",
      "000000000000000000000000000000000000000000000000000000000000000000000000000000000000000000000000000000000000000000000000",
      "000000000000000000000000000000000000000000000000000000000000000000000000000000000000000000000000000000000000000000000000",
      "000000000000000000000000000000000000000000000000000000000000000000000000000000000000000000000000000000000000000000000000",
      "000000000000000000000000000000000000000000000000000000000000000000000000000000000000000000000000000000000000000000000000",
      "000000000000000000000000000000000000000000000000000000000000000000000000000000000000000000000000000000000000000000000000",
      "000000000000000000000000000000000000000000000000000000000000000000000000000000000000000000000000000000000000000000000000",
      "000000000000000000000000000000000000000000000000000000000000000000000000000000000000000000000000000000000000000000000000",
      "000000000000000000000000000000000000000000000000000000000000000000000000000000000000000000000000000000000000000000000000",
      "000000000000000000000000000000000000000000000000000000000000000000000000000000000000000000000000000000000000000000000000",
      "000000000000000000000000000000000000000000000000000000000000000000000000000000000000000000000000000000000000000000000000",
      "000000000000000000000000000000000000000000000000000000000000000000000000000000000000000000000000000000000000000000000000",
      "000000000000000000000000000000000000000000000000000000000000000000000000000000000000000000000000000000000000000000000000",
      "000000000000000000000000000000000000000000000000000000000000000000000000000000000000000000000000000000000000000000000000",
      "000000000000000000000000000000000000000000000000000000000000000000000000000000000000000000000000000000000000000000000000",
      "000000000000000000000000000000000000000000000000000000000000000000000000000000000000000000000000000000000000000000000000",
      "000000000000000000000000000000000000000000000000000000000000000000000000000000000000000000000000000000000000000000000000",
      "000000000000000000000000000000000000000000000000000000000000000000000000000000000000000000000000000000000000000000000000",
      "000000000000000000000000000000000000000000000000000000000000000000000000000000000000000000000000000000000000000000000000",
      "000000000000000000000000000000000000000000000000000000000000000000000000000000000000000000000000000000000000000000000000",
      "000000000000000000000000000000000000000000000000000000000000000000000000000000000000000000000000000000000000000000000000",
      "000000000000000000000000000000000000000000000000000000000000000000000000000000000000000000000000000000000000000000000000",
      "000000000000000000000000000000000000000000000000000000000000000000000000000000000000000000000000000000000000000000000000",
      "000000000000000000000000000000000000000000000000000000000000000000000000000000000000000000000000000000000000000000000000",
      "000000000000000000000000000000000000000000000000000000000000000000000000000000000000000000000000000000000000000000000000",
      "000000000000000000000000000000000000000000000000000000000000000000000000000000000000000000000000000000000000000000000000",
      "000000000000000000000000000000000000000000000000000000000000000000000000000000000000000000000000000000000000000000000000",
      "000000000000000000000000000000000000000000000000000000000000000000000000000000000000000000000000000000000000000000000000",
      "000000000000000000000000000000000000000000000000000000000000000000000000000000000000000000000000000000000000000000000000",
      "000000000000000000000000000000000000000000000000000000000000000000000000000000000000000000000000000000000000000000000000",
      "000000000000000000000000000000000000000000000000000000000000000000000000000000000000000000000000000000000000000000000000",
      "000000000000000000000000000000000000000000000000000000000000000000000000000000000000000000000000000000000000000000000000",
      "000000000000000000000000000000000000000000000000000000000000000000000000000000000000000000000000000000000000000000000000",
      "000000000000000000000000000000000000000000000000000000000000000000000000000000000000000000000000000000000000000000000000",
      "000000000000000000000000000000000000000000000000000000000000000000000000000000000000000000000000000000000000000000000000",
      "000000000000000000000000000000000000000000000000000000000000000000000000000000000000000000000000000000000000000000000000",
      "000000000000000000000000000000000000000000000000000000000000000000000000000000000000000000000000000000000000000000000000",
      "000000000000000000000000000000000000000000000000000000000000000000000000000000000000000000000000000000000000000000000000",
      "000000000000000000000000000000000000000000000000000000000000000000000000000000000000000000000000000000000000000000000000",
      "000000000000000000000000000000000000000000000000000000000000000000000000000000000000000000000000000000000000000000000000",
      "000000000000000000000000000000000000000000000000000000000000000000000000000000000000000000000000000000000000000000000000",
      "000000000000000000000000000000000000000000000000000000000000000000000000000000000000000000000000000000000000000000000000",
      "000000000000000000000000000000000000000000000000000000000000000000000000000000000000000000000000000000000000000000000000",
      "000000000000000000000000000000000000000000000000000000000000000000000000000000000000000000000000000000000000000000000000",
      "000000000000000000000000000000000000000000000000000000000000000000000000000000000000000000000000000000000000000000000000",
      "000000000000000000000000000000000000000000000000000000000000000000000000000000000000000000000000000000000000000000000000",
      "000000000000000000000000000000000000000000000000000000000000000000000000000000000000000000000000000000000000000000000000",
      "000000000000000000000000000000000000000000000000000000000000000000000000000000000000000000000000000000000000000000000000",
      "000000000000000000000000000000000000000000000000000000000000000000000000000000000000000000000000000000000000000000000000",
      "000000000000000000000000000000000000000000000000000000000000000000000000000000000000000000000000000000000000000000000000",
      "000000000000000000000000000000000000000000000000000000000000000000000000000000000000000000000000000000000000000000000000",
      "000000000000000000000000000000000000000000000000000000000000000000000000000000000000000000000000000000000000000000000000"
    ],
    "sheet_id": 1003
  },
  "entities": [],
  "creep_spawn_enabled": false,
  "creep_spawn_interval": 0.0,
  "is_interior": false
}