{
  "id": 1727518223,
  "biome_tiles": {
    "tiles": [
      "000000000000000000000000000000000000000000000000000000000000000000000000000000000000000000000000000000000000000000000000",
      "000000000000000000000000000000000000000000000000000000000000000000000000000000000000000000000000000000000000000000000000",
      "066666666660000000000000000000000000000000000000000000000000000000000000000000000000000000000000000000000000000000000000",
      "066666666660000000000000000000000000000000000000000000000000000000000000000000000000000000000000000000000000000000000000",
      "066666666660000000000000000000000000000000000000000000000000000000000000000000000000000000000000000000000000000000000000",
      "066666666660000000000000000000000000000000000000000000000000000000000000000000000000000000000000000000000000000000000000",
      "066666666660000000000000000000000000000000000000000000000000000000000000000000000000000000000000000000000000000000000000",
      "066666666660000000000000000000000000000000000000000000000000000000000000000000000000000000000000000000000000000000000000",
      "000000000000000000000000000000000000000000000000000000000000000000000000000000000000000000000000000000000000000000000000",
      "000000000000000000000000000000000000000000000000000000000000000000000000000000000000000000000000000000000000000000000000",
      "000000000000000000000000000000000000000000000000000000000000000000000000000000000000000000000000000000000000000000000000",
      "000000000000000000000000000000000000000000000000000000000000000000000000000000000000000000000000000000000000000000000000",
      "000000000000000000000000000000000000000000000000000000000000000000000000000000000000000000000000000000000000000000000000",
      "000000000000000000000000000000000000000000000000000000000000000000000000000000000000000000000000000000000000000000000000",
      "000000000000000000000000000000000000000000000000000000000000000000000000000000000000000000000000000000000000000000000000",
      "000000000000000000000000000000000000000000000000000000000000000000000000000000000000000000000000000000000000000000000000",
      "000000000000000000000000000000000000000000000000000000000000000000000000000000000000000000000000000000000000000000000000",
      "000000000000000000000000000000000000000000000000000000000000000000000000000000000000000000000000000000000000000000000000",
      "000000000000000000000000000000000000000000000000000000000000000000000000000000000000000000000000000000000000000000000000",
      "000000000000000000000000000000000000000000000000000000000000000000000000000000000000000000000000000000000000000000000000",
      "000000000000000000000000000000000000000000000000000000000000000000000000000000000000000000000000000000000000000000000000",
      "000000000000000000000000000000000000000000000000000000000000000000000000000000000000000000000000000000000000000000000000",
      "000000000000000000000000000000000000000000000000000000000000000000000000000000000000000000000000000000000000000000000000",
      "000000000000000000000000000000000000000000000000000000000000000000000000000000000000000000000000000000000000000000000000",
      "000000000000000000000000000000000000000000000000000000000000000000000000000000000000000000000000000000000000000000000000",
      "000000000000000000000000000000000000000000000000000000000000000000000000000000000000000000000000000000000000000000000000",
      "000000000000000000000000000000000000000000000000000000000000000000000000000000000000000000000000000000000000000000000000",
      "000000000000000000000000000000000000000000000000000000000000000000000000000000000000000000000000000000000000000000000000",
      "000000000000000000000000000000000000000000000000000000000000000000000000000000000000000000000000000000000000000000000000",
      "000000000000000000000000000000000000000000000000000000000000000000000000000000000000000000000000000000000000000000000000",
      "000000000000000000000000000000000000000000000000000000000000000000000000000000000000000000000000000000000000000000000000",
      "000000000000000000000000000000000000000000000000000000000000000000000000000000000000000000000000000000000000000000000000",
      "000000000000000000000000000000000000000000000000000000000000000000000000000000000000000000000000000000000000000000000000",
      "000000000000000000000000000000000000000000000000000000000000000000000000000000000000000000000000000000000000000000000000",
      "000000000000000000000000000000000000000000000000000000000000000000000000000000000000000000000000000000000000000000000000",
      "000000000000000000000000000000000000000000000000000000000000000000000000000000000000000000000000000000000000000000000000",
      "000000000000000000000000000000000000000000000000000000000000000000000000000000000000000000000000000000000000000000000000",
      "000000000000000000000000000000000000000000000000000000000000000000000000000000000000000000000000000000000000000000000000",
      "000000000000000000000000000000000000000000000000000000000000000000000000000000000000000000000000000000000000000000000000",
      "000000000000000000000000000000000000000000000000000000000000000000000000000000000000000000000000000000000000000000000000",
      "000000000000000000000000000000000000000000000000000000000000000000000000000000000000000000000000000000000000000000000000",
      "000000000000000000000000000000000000000000000000000000000000000000000000000000000000000000000000000000000000000000000000",
      "000000000000000000000000000000000000000000000000000000000000000000000000000000000000000000000000000000000000000000000000",
      "000000000000000000000000000000000000000000000000000000000000000000000000000000000000000000000000000000000000000000000000",
      "000000000000000000000000000000000000000000000000000000000000000000000000000000000000000000000000000000000000000000000000",
      "000000000000000000000000000000000000000000000000000000000000000000000000000000000000000000000000000000000000000000000000",
      "000000000000000000000000000000000000000000000000000000000000000000000000000000000000000000000000000000000000000000000000",
      "000000000000000000000000000000000000000000000000000000000000000000000000000000000000000000000000000000000000000000000000",
      "000000000000000000000000000000000000000000000000000000000000000000000000000000000000000000000000000000000000000000000000",
      "000000000000000000000000000000000000000000000000000000000000000000000000000000000000000000000000000000000000000000000000",
      "000000000000000000000000000000000000000000000000000000000000000000000000000000000000000000000000000000000000000000000000",
      "000000000000000000000000000000000000000000000000000000000000000000000000000000000000000000000000000000000000000000000000",
      "000000000000000000000000000000000000000000000000000000000000000000000000000000000000000000000000000000000000000000000000",
      "000000000000000000000000000000000000000000000000000000000000000000000000000000000000000000000000000000000000000000000000",
      "000000000000000000000000000000000000000000000000000000000000000000000000000000000000000000000000000000000000000000000000",
      "000000000000000000000000000000000000000000000000000000000000000000000000000000000000000000000000000000000000000000000000",
      "000000000000000000000000000000000000000000000000000000000000000000000000000000000000000000000000000000000000000000000000",
      "000000000000000000000000000000000000000000000000000000000000000000000000000000000000000000000000000000000000000000000000",
      "000000000000000000000000000000000000000000000000000000000000000000000000000000000000000000000000000000000000000000000000",
      "000000000000000000000000000000000000000000000000000000000000000000000000000000000000000000000000000000000000000000000000",
      "000000000000000000000000000000000000000000000000000000000000000000000000000000000000000000000000000000000000000000000000",
      "000000000000000000000000000000000000000000000000000000000000000000000000000000000000000000000000000000000000000000000000",
      "000000000000000000000000000000000000000000000000000000000000000000000000000000000000000000000000000000000000000000000000",
      "000000000000000000000000000000000000000000000000000000000000000000000000000000000000000000000000000000000000000000000000",
      "000000000000000000000000000000000000000000000000000000000000000000000000000000000000000000000000000000000000000000000000",
      "000000000000000000000000000000000000000000000000000000000000000000000000000000000000000000000000000000000000000000000000",
      "000000000000000000000000000000000000000000000000000000000000000000000000000000000000000000000000000000000000000000000000",
      "000000000000000000000000000000000000000000000000000000000000000000000000000000000000000000000000000000000000000000000000",
      "000000000000000000000000000000000000000000000000000000000000000000000000000000000000000000000000000000000000000000000000",
      "000000000000000000000000000000000000000000000000000000000000000000000000000000000000000000000000000000000000000000000000",
      "000000000000000000000000000000000000000000000000000000000000000000000000000000000000000000000000000000000000000000000000",
      "000000000000000000000000000000000000000000000000000000000000000000000000000000000000000000000000000000000000000000000000",
      "000000000000000000000000000000000000000000000000000000000000000000000000000000000000000000000000000000000000000000000000",
      "000000000000000000000000000000000000000000000000000000000000000000000000000000000000000000000000000000000000000000000000",
      "000000000000000000000000000000000000000000000000000000000000000000000000000000000000000000000000000000000000000000000000",
      "000000000000000000000000000000000000000000000000000000000000000000000000000000000000000000000000000000000000000000000000",
      "000000000000000000000000000000000000000000000000000000000000000000000000000000000000000000000000000000000000000000000000",
      "000000000000000000000000000000000000000000000000000000000000000000000000000000000000000000000000000000000000000000000000",
      "000000000000000000000000000000000000000000000000000000000000000000000000000000000000000000000000000000000000000000000000",
      "000000000000000000000000000000000000000000000000000000000000000000000000000000000000000000000000000000000000000000000000"
    ],
    "sheet_id": 1002
  },
  "constructions_tiles": {
    "tiles": [
      "444444444440000000000000000000000000000000000000000000000000000000000000000000000000000000000000000000000000000000000000",
      "444444444440000000000000000000000000000000000000000000000000000000000000000000000000000000000000000000000000000000000000",
      "400000000000000000000000000000000000000000000000000000000000000000000000000000000000000000000000000000000000000000000000",
      "400000000000000000000000000000000000000000000000000000000000000000000000000000000000000000000000000000000000000000000000",
      "400000000000000000000000000000000000000000000000000000000000000000000000000000000000000000000000000000000000000000000000",
      "400000000000000000000000000000000000000000000000000000000000000000000000000000000000000000000000000000000000000000000000",
      "400000000000000000000000000000000000000000000000000000000000000000000000000000000000000000000000000000000000000000000000",
      "400000000000000000000000000000000000000000000000000000000000000000000000000000000000000000000000000000000000000000000000",
      "444444444440000000000000000000000000000000000000000000000000000000000000000000000000000000000000000000000000000000000000",
      "000000000000000000000000000000000000000000000000000000000000000000000000000000000000000000000000000000000000000000000000",
      "000000000000000000000000000000000000000000000000000000000000000000000000000000000000000000000000000000000000000000000000",
      "000000000000000000000000000000000000000000000000000000000000000000000000000000000000000000000000000000000000000000000000",
      "000000000000000000000000000000000000000000000000000000000000000000000000000000000000000000000000000000000000000000000000",
      "000000000000000000000000000000000000000000000000000000000000000000000000000000000000000000000000000000000000000000000000",
      "000000000000000000000000000000000000000000000000000000000000000000000000000000000000000000000000000000000000000000000000",
      "000000000000000000000000000000000000000000000000000000000000000000000000000000000000000000000000000000000000000000000000",
      "000000000000000000000000000000000000000000000000000000000000000000000000000000000000000000000000000000000000000000000000",
      "000000000000000000000000000000000000000000000000000000000000000000000000000000000000000000000000000000000000000000000000",
      "000000000000000000000000000000000000000000000000000000000000000000000000000000000000000000000000000000000000000000000000",
      "000000000000000000000000000000000000000000000000000000000000000000000000000000000000000000000000000000000000000000000000",
      "000000000000000000000000000000000000000000000000000000000000000000000000000000000000000000000000000000000000000000000000",
      "000000000000000000000000000000000000000000000000000000000000000000000000000000000000000000000000000000000000000000000000",
      "000000000000000000000000000000000000000000000000000000000000000000000000000000000000000000000000000000000000000000000000",
      "000000000000000000000000000000000000000000000000000000000000000000000000000000000000000000000000000000000000000000000000",
      "000000000000000000000000000000000000000000000000000000000000000000000000000000000000000000000000000000000000000000000000",
      "000000000000000000000000000000000000000000000000000000000000000000000000000000000000000000000000000000000000000000000000",
      "000000000000000000000000000000000000000000000000000000000000000000000000000000000000000000000000000000000000000000000000",
      "000000000000000000000000000000000000000000000000000000000000000000000000000000000000000000000000000000000000000000000000",
      "000000000000000000000000000000000000000000000000000000000000000000000000000000000000000000000000000000000000000000000000",
      "000000000000000000000000000000000000000000000000000000000000000000000000000000000000000000000000000000000000000000000000",
      "000000000000000000000000000000000000000000000000000000000000000000000000000000000000000000000000000000000000000000000000",
      "000000000000000000000000000000000000000000000000000000000000000000000000000000000000000000000000000000000000000000000000",
      "000000000000000000000000000000000000000000000000000000000000000000000000000000000000000000000000000000000000000000000000",
      "000000000000000000000000000000000000000000000000000000000000000000000000000000000000000000000000000000000000000000000000",
      "000000000000000000000000000000000000000000000000000000000000000000000000000000000000000000000000000000000000000000000000",
      "000000000000000000000000000000000000000000000000000000000000000000000000000000000000000000000000000000000000000000000000",
      "000000000000000000000000000000000000000000000000000000000000000000000000000000000000000000000000000000000000000000000000",
      "000000000000000000000000000000000000000000000000000000000000000000000000000000000000000000000000000000000000000000000000",
      "000000000000000000000000000000000000000000000000000000000000000000000000000000000000000000000000000000000000000000000000",
      "000000000000000000000000000000000000000000000000000000000000000000000000000000000000000000000000000000000000000000000000",
      "000000000000000000000000000000000000000000000000000000000000000000000000000000000000000000000000000000000000000000000000",
      "000000000000000000000000000000000000000000000000000000000000000000000000000000000000000000000000000000000000000000000000",
      "000000000000000000000000000000000000000000000000000000000000000000000000000000000000000000000000000000000000000000000000",
      "000000000000000000000000000000000000000000000000000000000000000000000000000000000000000000000000000000000000000000000000",
      "000000000000000000000000000000000000000000000000000000000000000000000000000000000000000000000000000000000000000000000000",
      "000000000000000000000000000000000000000000000000000000000000000000000000000000000000000000000000000000000000000000000000",
      "000000000000000000000000000000000000000000000000000000000000000000000000000000000000000000000000000000000000000000000000",
      "000000000000000000000000000000000000000000000000000000000000000000000000000000000000000000000000000000000000000000000000",
      "000000000000000000000000000000000000000000000000000000000000000000000000000000000000000000000000000000000000000000000000",
      "000000000000000000000000000000000000000000000000000000000000000000000000000000000000000000000000000000000000000000000000",
      "000000000000000000000000000000000000000000000000000000000000000000000000000000000000000000000000000000000000000000000000",
      "000000000000000000000000000000000000000000000000000000000000000000000000000000000000000000000000000000000000000000000000",
      "000000000000000000000000000000000000000000000000000000000000000000000000000000000000000000000000000000000000000000000000",
      "000000000000000000000000000000000000000000000000000000000000000000000000000000000000000000000000000000000000000000000000",
      "000000000000000000000000000000000000000000000000000000000000000000000000000000000000000000000000000000000000000000000000",
      "000000000000000000000000000000000000000000000000000000000000000000000000000000000000000000000000000000000000000000000000",
      "000000000000000000000000000000000000000000000000000000000000000000000000000000000000000000000000000000000000000000000000",
      "000000000000000000000000000000000000000000000000000000000000000000000000000000000000000000000000000000000000000000000000",
      "000000000000000000000000000000000000000000000000000000000000000000000000000000000000000000000000000000000000000000000000",
      "000000000000000000000000000000000000000000000000000000000000000000000000000000000000000000000000000000000000000000000000",
      "000000000000000000000000000000000000000000000000000000000000000000000000000000000000000000000000000000000000000000000000",
      "000000000000000000000000000000000000000000000000000000000000000000000000000000000000000000000000000000000000000000000000",
      "000000000000000000000000000000000000000000000000000000000000000000000000000000000000000000000000000000000000000000000000",
      "000000000000000000000000000000000000000000000000000000000000000000000000000000000000000000000000000000000000000000000000",
      "000000000000000000000000000000000000000000000000000000000000000000000000000000000000000000000000000000000000000000000000",
      "000000000000000000000000000000000000000000000000000000000000000000000000000000000000000000000000000000000000000000000000",
      "000000000000000000000000000000000000000000000000000000000000000000000000000000000000000000000000000000000000000000000000",
      "000000000000000000000000000000000000000000000000000000000000000000000000000000000000000000000000000000000000000000000000",
      "000000000000000000000000000000000000000000000000000000000000000000000000000000000000000000000000000000000000000000000000",
      "000000000000000000000000000000000000000000000000000000000000000000000000000000000000000000000000000000000000000000000000",
      "000000000000000000000000000000000000000000000000000000000000000000000000000000000000000000000000000000000000000000000000",
      "000000000000000000000000000000000000000000000000000000000000000000000000000000000000000000000000000000000000000000000000",
      "000000000000000000000000000000000000000000000000000000000000000000000000000000000000000000000000000000000000000000000000",
      "000000000000000000000000000000000000000000000000000000000000000000000000000000000000000000000000000000000000000000000000",
      "000000000000000000000000000000000000000000000000000000000000000000000000000000000000000000000000000000000000000000000000",
      "000000000000000000000000000000000000000000000000000000000000000000000000000000000000000000000000000000000000000000000000",
      "000000000000000000000000000000000000000000000000000000000000000000000000000000000000000000000000000000000000000000000000",
      "000000000000000000000000000000000000000000000000000000000000000000000000000000000000000000000000000000000000000000000000",
      "000000000000000000000000000000000000000000000000000000000000000000000000000000000000000000000000000000000000000000000000",
      "000000000000000000000000000000000000000000000000000000000000000000000000000000000000000000000000000000000000000000000000"
    ],
    "sheet_id": 1003
  },
  "entities": [
    {
      "id": 1727518234,
      "frame": {
        "x": 8,
        "y": 1,
        "w": 1,
        "h": 2
      },
      "name": "Stairs (Down)",
      "species_id": 1011,
      "entity_type": "StaticObject",
      "offset": {
        "x": 0.0,
        "y": 0.0
      },
      "direction": 1,
      "current_speed": 0.0,
      "is_rigid": true,
      "z_index": 1000,
      "sprite": {
        "sheet_id": 1010,
        "frame": {
          "x": 2,
          "y": 0,
          "w": 1,
          "h": 2
        },
        "number_of_frames": 1
      },
      "dialogues": [],
      "time_immobilized": 0.0,
      "destination": null,
      "lock_type": "None",
      "original_sprite_frame": {
        "x": 2,
        "y": 0,
        "w": 1,
        "h": 2
      },
      "speed_multiplier": 1.0,
      "melee_attacks_hero": false,
      "is_dying": false,
      "patrol": {
        "initial_position": [
          0,
          0
        ],
        "current_index": 0,
        "movements": []
      },
      "latest_movement": [
        0,
        0
      ],
      "contents": null,
      "remaining_lifespan": -420.0,
      "shooting_cooldown_remaining": 0.0,
      "parent_id": 0,
      "is_invulnerable": true,
      "demands_attention": false
    },
    {
      "id": 1727518235,
      "frame": {
        "x": 8,
        "y": 2,
        "w": 1,
        "h": 1
      },
      "name": "Teleporter",
      "species_id": 1019,
      "entity_type": "Teleporter",
      "offset": {
        "x": 0.0,
        "y": 0.0
      },
      "direction": 1,
      "current_speed": 0.0,
      "is_rigid": false,
      "z_index": 200,
      "sprite": {
        "sheet_id": 1008,
        "frame": {
          "x": 0,
          "y": 0,
          "w": 1,
          "h": 1
        },
        "number_of_frames": 1
      },
      "dialogues": [],
      "time_immobilized": 0.0,
      "destination": {
        "world": 1727518222,
        "x": 0,
        "y": 0
      },
      "lock_type": "None",
      "original_sprite_frame": {
        "x": 0,
        "y": 0,
        "w": 1,
        "h": 1
      },
      "speed_multiplier": 1.0,
      "melee_attacks_hero": false,
      "is_dying": false,
      "patrol": {
        "initial_position": [
          0,
          0
        ],
        "current_index": 0,
        "movements": []
      },
      "latest_movement": [
        0,
        0
      ],
      "contents": null,
      "remaining_lifespan": -420.0,
      "shooting_cooldown_remaining": 0.0,
      "parent_id": 0,
      "is_invulnerable": true,
      "demands_attention": false
    }
  ],
  "creep_spawn_enabled": false,
  "creep_spawn_interval": 5.0,
  "is_interior": false
}