{
  "id": 1000,
  "biome_tiles": {
    "tiles": [
      "222222222222222222222222222222222222222222222222222222222222222222222222222222222222222222222222222222222222222222222222",
      "222224242222222222242422242224244242242424222222222222422242242224422222442224222222422422222422242442422222224422244222",
      "224141444411144114441144441444144144444444444411444441441144444141444144444414144111114444441414411414414414441414444422",
      "244114111414414414411444111441111141411444141141441144441141144411111444111144411414111114141111414114144144441141411122",
      "244111111111111111111111111111111111111111111111111111111111111111111111111111111111111111111111111111111111111111114422",
      "244111111111111111111111111111111111111111111111111111111111111111111111111111111111111111111111111111111111111111111422",
      "221411111111111111111111111111111111111111111111111111111111111111111111111111111111111111111111111111111111111111111442",
      "244411111111111111111111111111111111111111111111111111111111111111111111111111111111111111111111111111111111111111114422",
      "221111111111111111111111111111111111111111111111111111111111111111111111111111111111111111111111111111111111111111114422",
      "224411111111111111111111111111111111111111111111111111111111111111111111111111111111111111111111111111111111111111114122",
      "244411111111111111111111111111111111111111111111111111111111111111111111111111111111111111111111111111111111111111111422",
      "224111111111111111111111111111111111111111111111111111111111111111111111111111111111111111111111111111111111111111114422",
      "221111111111111111111111111111111111111111111111111111111111111111111111111111111111111111111111111111111111111111114422",
      "224111111111111111111111111111111111111111111111111111111111111111111111111111111111111111111111111111111111111111111422",
      "224411111111111111111111111111111111111111111111111111111111111111111111111111111111111111111111111111111111111111114122",
      "224411111111111111111111111111111111111111111111111111111111111111111111111111111111111111111111111111111111111111111422",
      "224111111111111111111111111111111111111111111111111111111111111111111111111111111111111111111111111111111111111111111422",
      "221111111111111111111111111111111111111111111111111111111111111111111111111111111111111111111111111111111111111111114442",
      "221111111111111111111111111111111111111111111111111111111111111111111111111111111111111111111111111111111111111111111442",
      "244111111111111111111111111111111111111111111111111111111111111111111111111111111111111111111111111111111111111111111122",
      "241411111111111111111111111111111111111111111111111111111111111111111111111111111111111111111111111111111111111111114422",
      "244111111111111111111111111111111111111111111111111111111111111111111111111111111111111111111111111111111111111111114422",
      "224111111111111111111111111111111111111111111111111111111111111111111111111111111111111111111111111111111111111111114422",
      "244411111111111111111111111111111111111111111111111111111111111111111111111111111111111111111111111111111111111111111422",
      "221111111111111111111111111111111111111111111111111111111111111111111111111111111111111111111111111111111111111111111142",
      "224411111111111111111111111111111111111111111111111111111111111111111111111111111111111111111111111111111111111111111142",
      "221111111111111111111111111111111111111111111111111111111111111111111111111111111111111111111111111111111111111111111422",
      "224411111111111111111111111111111111111111111111111111111111111111111111111111111111111111111111111111111111111111111422",
      "224111111111111111111111111111111111111111111111111111111111111111111111111111111111111111111111111111111111111111114422",
      "224411111111111111111111111111111111111111111111111111111111111111111111111111111111111111111111111111111111111111114422",
      "224111111111111111111111111111111111111111111111111111111111111111111111111111111111111111111111111111111111111111114142",
      "224411111111111111111111111111111111111111111111111111111111111111111111111111111111111111111111111111111111111111111122",
      "221111111111111111111111111111111111111111111111111111111111111111111111111111111111111111111111111111111111111111111122",
      "224411111111111111111111111111111111111111111111111111111111111111111111111111111111111111111111111111111111111111111422",
      "221411111111111111111111111111111111111111111111111111111111111111111111111111111111111111111111111111111111111111111122",
      "241411111111111111111111111111111111111111111111111111111111111111111111111111111111111111111111111111111111111111114422",
      "244111111111111111111111111111111111111111111111111111111111111111111111111111111111111111111111111111111111111111114422",
      "221111111111111111111111111111111111111111111111111111111111111111111111111111111111111111111111111111111111111111111442",
      "244411111111111111111111111111111111111111111111111111111111111111111111111111111111111111111111111111111111111111114422",
      "241411111111111111111111111111111111111111111111111111111111111111111111111111111111111111111111111111111111111111111442",
      "244111111111111111111111111111111111111111111111111111111111111111111111111111111111111111111111111111111111111111111442",
      "224411111111111111111111111111111111111111111111111111111111111111111111111111111111111111111111111111111111111111111442",
      "244111111111111111111111111111111111111111111111111111111111111111111111111111111111111111111111111111111111111111114422",
      "224111111111111111111111111111111111111111111111111111111111111111111111111111111111111111111111111111111111111111114442",
      "221111111111111111111111111111111111111111111111111111111111111111111111111111111111111111111111111111111111111111114442",
      "221411111111111111111111111111111111111111111111111111111111111111111111111111111111111111111111111111111111111111111422",
      "221411111111111111111111111111111111111111111111111111111111111111111111111111111111111111111111111111111111111111114422",
      "224111111111111111111111111111111111111111111111111111111111111111111111111111111111111111111111111111111111111111114122",
      "244411111111111111111111111111111111111111111111111111111111111111111111111111111111111111111111111111111111111111114422",
      "221411111111111111111111111111111111111111111111111111111111111111111111111111111111111111111111111111111111111111114442",
      "244411111111111111111111111111111111111111111111111111111111111111111111111111111111111111111111111111111111111111114422",
      "224111111111111111111111111111111111111111111111111111111111111111111111111111111111111111111111111111111111111111114122",
      "224111111111111111111111111111111111111111111111111111111111111111111111111111111111111111111111111111111111111111114122",
      "224411111111111111111111111111111111111111111111111111111111111111111111111111111111111111111111111111111111111111114122",
      "244411111111111111111111111111111111111111111111111111111111111111111111111111111111111111111111111111111111111111111422",
      "224111111111111111111111111111111111111111111111111111111111111111111111111111111111111111111111111111111111111111114122",
      "244111111111111111111111111111111111111111111111111111111111111111111111111111111111111111111111111111111111111111114442",
      "244111111111111111111111111111111111111111111111111111111111111111111111111111111111111111111111111111111111111111111142",
      "224111111111111111111111111111111111111111111111111111111111111111111111111111111111111111111111111111111111111111114422",
      "224111111111111111111111111111111111111111111111111111111111111111111111111111111111111111111111111111111111111111114442",
      "244111111111111111111111111111111111111111111111111111111111111111111111111111111111111111111111111111111111111111111122",
      "221411111111111111111111111111111111111111111111111111111111111111111111111111111111111111111111111111111111111111111442",
      "244411111111111111111111111111111111111111111111111111111111111111111111111111111111111111111111111111111111111111114122",
      "224111111111111111111111111111111111111111111111111111111111111111111111111111111111111111111111111111111111111111111122",
      "224411111111111111111111111111111111111111111111111111111111111111111111111111111111111111111111111111111111111111114422",
      "221111111111111111111111111111111111111111111111111111111111111111111111111111111111111111111111111111111111111111111142",
      "224411111111111111111111111111111111111111111111111111111111111111111111111111111111111111111111111111111111111111111422",
      "244111111111111111111111111111111111111111111111111111111111111111111111111111111111111111111111111111111111111111111422",
      "224111111111111111111111111111111111111111111111111111111111111111111111111111111111111111111111111111111111111111111422",
      "221111111111111111111111111111111111111111111111111111111111111111111111111111111111111111111111111111111111111111111422",
      "221411111111111111111111111111111111111111111111111111111111111111111111111111111111111111111111111111111111111111111122",
      "224411111111111111111111111111111111111111111111111111111111111111111111111111111111111111111111111111111111111111114122",
      "244111111111111111111111111111111111111111111111111111111111111111111111111111111111111111111111111111111111111111111422",
      "221111111111111111111111111111111111111111111111111111111111111111111111111111111111111111111111111111111111111111114422",
      "224111111111111111111111111111111111111111111111111111111111111111111111111111111111111111111111111111111111111111111422",
      "244111111111111111111111111111111111111111111111111111111111111111111111111111111111111111111111111111111111111111111442",
      "244141111414111441144141144411414111411144111141414144141111144111441111441141141444111441141444441114441144144441114122",
      "224414441414444414141444414414441411414114414111111414444441144414144114441444144411414444414441144414444144444144441422",
      "242242422222224222242424222424422422222422222222422224424422222222222424224422222224444222222242424444222442242224222222",
      "222222222222222222222222222222222222222222222222222222222222222222222222222222222222222222222222222222222222222222222222"
    ],
    "sheet_id": 1002
  },
  "construction_tiles": {
    "tiles": [
      "000000000000000000000000000000000000000000000000000000000000000000000000000000000000000000000000000000000000000000000000",
      "000000000000000000000000000000000000000000000000000000000000000000000000000000000000000000000000000000000000000000000000",
      "000000000000000000000000000000000000000000000000000000000000000000000000000000000000000000000000000000000000000000000000",
      "000000000000000000000000000000000000000000000000000000000000000000000000000000000000000000000000000000000000000000000000",
      "000000000000000000000000000000000000000000000000000000000000000000000000000000000000000000000000000000000000000000000000",
      "000000000000000000000000000000000000000000000000000000000000000000000000000000000000000000000000000000000000000000000000",
      "000000000000000000000000000000000000000000000000000000000000000000000000000000000000000000000000000000000000000000000000",
      "000000000000000000000000000000000000000000000000000000000000000000000000000000000000000000000000000000000000000000000000",
      "000000000000000000000000000000000000000000000000000000000000000000000000000000000000000000000000000000000000000000000000",
      "000000000000000000000000000000000000000000000000000000000000000000000000000000000000000000000000000000000000000000000000",
      "000000000000000000000000000000000000000000000000000000000000000000000000000000000000000000000000000000000000000000000000",
      "000000000000000000000000000000000000000000000000000000000000000000000000000000000000000000000000000000000000000000000000",
      "000000000000000000000000000000000000000000000000000000000000000000000000000000000000000000000000000000000000000000000000",
      "000000000000000000000000000000000000000000000000000000000000000000000000000000000000000000000000000000000000000000000000",
      "000000000000000000000000000000000000000000000000000000000000000000000000000000000000000000000000000000000000000000000000",
      "000000000000000000000000000000000000000000000000000000000000000000000000000000000000000000000000000000000000000000000000",
      "000000000000000000000000000000000000000000000000000000000000000000000000000000000000000000000000000000000000000000000000",
      "000000000000000000000000000000000000000000000000000000000000000000000000000000000000000000000000000000000000000000000000",
      "000000000000000000000000000000000000000000000000000000000000000000000000000000000000000000000000000000000000000000000000",
      "000000000000000000000000000000000000000000000000000000000000000000000000000000000000000000000000000000000000000000000000",
      "000000000000000000000000000000000000000000000000000000000000000000000000000000000000000000000000000000000000000000000000",
      "000000000000000000000000000000000000000000000000000000000000000000000000000000000000000000000000000000000000000000000000",
      "000000000000000000000000000000000000000000000000000000000000000000000000000000000000000000000000000000000000000000000000",
      "000000000000000000000000000000000000000000000000000000000000000000000000000000000000000000000000000000000000000000000000",
      "000000000000000000000000000000000000000000000000000000000000000000000000000000000000000000000000000000000000000000000000",
      "000000000000000000000000000000000000000000000000000000000000000000000000000000000000000000000000000000000000000000000000",
      "000000000000000000000000000000000000000000000000000000000000000000000000000000000000000000000000000000000000000000000000",
      "000000000000000000000000000000000000000000000000000000000000000000000000000000000000000000000000000000000000000000000000",
      "000000000000000000000000000000000000000000000000000000000000000000000000000000000000000000000000000000000000000000000000",
      "000000000000000000000000000000000000000000000000000000000000000000000000000000000000000000000000000000000000000000000000",
      "000000000000000000000000000000000000000000000000000000000000000000000000000000000000000000000000000000000000000000000000",
      "000000000000000000000000000000000000000000000000000000000000000000000000000000000000000000000000000000000000000000000000",
      "000000000000000000000000000000000000000000000000000000000000000000000000000000000000000000000000000000000000000000000000",
      "000000000000000000000000000000000000000000000000000000000000000000000000000000000000000000000000000000000000000000000000",
      "000000000000000000000000000000000000000000000000000000000000000000000000000000000000000000000000000000000000000000000000",
      "000000000000000000000000000000000000000000000000000000000000000000000000000000000000000000000000000000000000000000000000",
      "000000000000000000000000000000000000000000000000000000000000000000000000000000000000000000000000000000000000000000000000",
      "000000000000000000000000000000000000000000000000000000000000000000000000000000000000000000000000000000000000000000000000",
      "000000000000000000000000000000000000000000000000000000000000000000000000000000000000000000000000000000000000000000000000",
      "000000000000000000000000000000000000000000000000000000000000000000000000000000000000000000000000000000000000000000000000",
      "000000000000000000000000000000000000000000000000000000000000000000000000000000000000000000000000000000000000000000000000",
      "000000000000000000000000000000000000000000000000000000000000000000000000000000000000000000000000000000000000000000000000",
      "000000000000000000000000000000000000000000000000000000000000000000000000000000000000000000000000000000000000000000000000",
      "000000000000000000000000000000000000000000000000000000000000000000000000000000000000000000000000000000000000000000000000",
      "000000000000000000000000000000000000000000000000000000000000000000000000000000000000000000000000000000000000000000000000",
      "000000000000000000000000000000000000000000000000000000000000000000000000000000000000000000000000000000000000000000000000",
      "000000000000000000000000000000000000000000000000000000000000000000000000000000000000000000000000000000000000000000000000",
      "000000000000000000000000000000000000000000000000000000000000000000000000000000000000000000000000000000000000000000000000",
      "000000000000000000000000000000000000000000000000000000000000000000000000000000000000000000000000000000000000000000000000",
      "000000000000000000000000000000000000000000000000000000000000000000000000000000000000000000000000000000000000000000000000",
      "000000000000000000000000000000000000000000000000000000000000000000000000000000000000000000000000000000000000000000000000",
      "000000000000000000000000000000000000000000000000000000000000000000000000000000000000000000000000000000000000000000000000",
      "000000000000000000000000000000000000000000000000000000000000000000000000000000000000000000000000000000000000000000000000",
      "000000000000000000000000000000000000000000000000000000000000000000000000000000000000000000000000000000000000000000000000",
      "000000000000000000000000000000000000000000000000000000000000000000000000000000000000000000000000000000000000000000000000",
      "000000000000000000000000000000000000000000000000000000000000000000000000000000000000000000000000000000000000000000000000",
      "000000000000000000000000000000000000000000000000000000000000000000000000000000000000000000000000000000000000000000000000",
      "000000000000000000000000000000000000000000000000000000000000000000000000000000000000000000000000000000000000000000000000",
      "000000000000000000000000000000000000000000000000000000000000000000000000000000000000000000000000000000000000000000000000",
      "000000000000000000000000000000000000000000000000000000000000000000000000000000000000000000000000000000000000000000000000",
      "000000000000000000000000000000000000000000000000000000000000000000000000000000000000000000000000000000000000000000000000",
      "000000000000000000000000000000000000000000000000000000000000000000000000000000000000000000000000000000000000000000000000",
      "000000000000000000000000000000000000000000000000000000000000000000000000000000000000000000000000000000000000000000000000",
      "000000000000000000000000000000000000000000000000000000000000000000000000000000000000000000000000000000000000000000000000",
      "000000000000000000000000000000000000000000000000000000000000000000000000000000000000000000000000000000000000000000000000",
      "000000000000000000000000000000000000000000000000000000000000000000000000000000000000000000000000000000000000000000000000",
      "000000000000000000000000000000000000000000000000000000000000000000000000000000000000000000000000000000000000000000000000",
      "000000000000000000000000000000000000000000000000000000000000000000000000000000000000000000000000000000000000000000000000",
      "000000000000000000000000000000000000000000000000000000000000000000000000000000000000000000000000000000000000000000000000",
      "000000000000000000000000000000000000000000000000000000000000000000000000000000000000000000000000000000000000000000000000",
      "000000000000000000000000000000000000000000000000000000000000000000000000000000000000000000000000000000000000000000000000",
      "000000000000000000000000000000000000000000000000000000000000000000000000000000000000000000000000000000000000000000000000",
      "000000000000000000000000000000000000000000000000000000000000000000000000000000000000000000000000000000000000000000000000",
      "000000000000000000000000000000000000000000000000000000000000000000000000000000000000000000000000000000000000000000000000",
      "000000000000000000000000000000000000000000000000000000000000000000000000000000000000000000000000000000000000000000000000",
      "000000000000000000000000000000000000000000000000000000000000000000000000000000000000000000000000000000000000000000000000",
      "000000000000000000000000000000000000000000000000000000000000000000000000000000000000000000000000000000000000000000000000",
      "000000000000000000000000000000000000000000000000000000000000000000000000000000000000000000000000000000000000000000000000",
      "000000000000000000000000000000000000000000000000000000000000000000000000000000000000000000000000000000000000000000000000",
      "000000000000000000000000000000000000000000000000000000000000000000000000000000000000000000000000000000000000000000000000"
    ],
    "sheet_id": 1002
  },
  "entities": [],
  "creep_spawn_enabled": false,
  "creep_spawn_interval": 0.0,
  "is_interior": false
}